"abu","acum_busd","acum_busd_val","acum_val_bu","acum_val_sd","acum_val","avg_val_bu","avg_val_sd","rbusd","asd","auk","bs","bu","bu-sd","bu-sd_val","c","date","datetime","h","l","o","pbu","psd","puk","rbu","rsd","ruk","sb","sd","sum_vol","total_vol","uk","val","val_bu","val_sd","val_uk"
65519.1,212400,4040270000,4981510000,941240000,5922750000,1236386808.5,1298934574.5,-64.6,69025.5,13366,5.3,261800,212400,4040270000,19050,"2023-02-21T09:15:00.000Z",1676970900000,19100,18950,19000,84.1,15.9,0,4,0.7,,0.2,49400,311200,311200,,5922750000,4981510000,941240000,
65519.1,178200,3392045000,6150405000,2758360000,8908765000,1236386808.5,1298934574.5,10.4,69025.5,13366,0.6,61200,-34200,-648225000,19050,"2023-02-21T09:20:00.000Z",1676971200000,19100,19000,19050,39.1,60.9,0,0.9,1.4,,1.6,95400,156600,467800,,2986015000,1168895000,1817120000,
65519.1,98900,1887105000,6997770000,5110665000,12108435000,1236386808.5,1298934574.5,24.1,69025.5,13366,0.4,44500,-79300,-1504940000,19000,"2023-02-21T09:25:00.000Z",1676971500000,19050,18950,19050,26.4,73.6,0,0.7,1.8,,2.8,123800,168300,636100,,3199670000,847365000,2352305000,
65519.1,-103100,-1933100000,7962610000,9895710000,17858320000,1236386808.5,1298934574.5,61.1,69025.5,13366,0.2,51000,-202000,-3820205000,18850,"2023-02-21T09:30:00.000Z",1676971800000,19000,18850,19000,16.8,83.2,0,0.8,3.7,,5,253000,304000,940100,,5749885000,964840000,4785045000,
65519.1,-117900,-2211530000,9301215000,11512745000,21002460000,1236386808.5,1298934574.5,4.5,69025.5,13366,0.8,70900,-14800,-278430000,18950,"2023-02-21T09:35:00.000Z",1676972100000,18950,18800,18900,42.6,51.4,6,1.1,1.2,0.7,1.2,85700,166600,1106700,10000,3144140000,1338605000,1617035000,188500000
65519.1,-28700,-518525000,11229190000,11747715000,23165405000,1236386808.5,1298934574.5,-27.1,69025.5,13366,8.2,101600,89200,1693005000,19000,"2023-02-21T09:40:00.000Z",1676972400000,19000,18900,18900,89.1,10.9,0,1.6,0.2,,0.1,12400,114000,1220700,,2162945000,1927975000,234970000,
65519.1,-31900,-575745000,12578060000,13153805000,25920365000,1236386808.5,1298934574.5,0.9,69025.5,13366,1,71000,-3200,-57220000,18950,"2023-02-21T09:45:00.000Z",1676972700000,19000,18950,18950,48.9,51.1,0,1.1,1.1,,1,74200,145200,1365900,,2754960000,1348870000,1406090000,
65519.1,-123400,-2303145000,13289150000,15592295000,29069945000,1236386808.5,1298934574.5,27.6,69025.5,13366,0.3,37500,-91500,-1727400000,18900,"2023-02-21T09:50:00.000Z",1676973000000,19000,18850,19000,22.5,77.5,0,0.6,1.9,,3.4,129000,166500,1532400,,3149580000,711090000,2438490000,
65519.1,-136200,-2539115000,15296330000,17835445000,33320275000,1236386808.5,1298934574.5,3.8,69025.5,13366,0.9,106200,-12800,-235970000,18900,"2023-02-21T09:55:00.000Z",1676973300000,18900,18850,18900,47.2,52.8,0,1.6,1.7,,1.1,119000,225200,1757600,,4250330000,2007180000,2243150000,
65519.1,-156800,-2926605000,16009545000,18936150000,35134195000,1236386808.5,1298934574.5,6.2,69025.5,13366,0.6,37800,-20600,-387490000,18850,"2023-02-21T10:00:00.000Z",1676973600000,18900,18800,18900,39.3,60.7,0,0.6,0.8,,1.5,58400,96200,1853800,,1813920000,713215000,1100705000,
65519.1,-221000,-4131425000,16816325000,20947750000,37952575000,1236386808.5,1298934574.5,19.3,69025.5,13366,0.4,42800,-64200,-1204820000,18850,"2023-02-21T10:05:00.000Z",1676973900000,18850,18800,18850,28.6,71.4,0,0.7,1.6,,2.5,107000,149800,2003600,,2818380000,806780000,2011600000,
65519.1,-179700,-3352495000,17728735000,21081230000,38998465000,1236386808.5,1298934574.5,-12.5,69025.5,13366,6.8,48400,41300,778930000,18900,"2023-02-21T10:10:00.000Z",1676974200000,18900,18800,18850,87.2,12.8,0,0.7,0.1,,0.1,7100,55500,2059100,,1045890000,912410000,133480000,
65519.1,-26200,-450260000,21040015000,21490275000,42718790000,1236386808.5,1298934574.5,-46.4,69025.5,13366,8.1,175200,153500,2902235000,18900,"2023-02-21T10:15:00.000Z",1676974500000,18900,18850,18850,89,11,0,2.7,0.3,,0.1,21700,196900,2256000,,3720325000,3311280000,409045000,
65519.1,49400,979385000,22664080000,21684695000,44537275000,1236386808.5,1298934574.5,-22.9,69025.5,13366,8.3,85900,75600,1429645000,18950,"2023-02-21T10:20:00.000Z",1676974800000,18950,18850,18900,89.3,10.7,0,1.3,0.1,,0.1,10300,96200,2352200,,1818485000,1624065000,194420000,
65519.1,98400,1907700000,25154375000,23246675000,48589550000,1236386808.5,1298934574.5,-14.8,69025.5,13366,1.6,131700,49000,928315000,18900,"2023-02-21T10:25:00.000Z",1676975100000,18950,18850,18950,61.4,38.6,0,2,1.2,,0.6,82700,214400,2566600,,4052275000,2490295000,1561980000,
65519.1,211000,4036055000,27290280000,23254225000,50733005000,1236386808.5,1298934574.5,-34,69025.5,13366,282.5,113000,112600,2128355000,18950,"2023-02-21T10:30:00.000Z",1676975400000,18950,18850,18900,99.6,0.4,0,1.7,0,,0,400,113400,2680000,,2143455000,2135905000,7550000,
65519.1,216300,4136850000,28088475000,23951625000,52228600000,1236386808.5,1298934574.5,-1.6,69025.5,13366,1.1,42200,5300,100795000,18900,"2023-02-21T10:35:00.000Z",1676975700000,18950,18850,18950,53.4,46.6,0,0.6,0.5,,0.9,36900,79100,2759100,,1495595000,798195000,697400000,
65519.1,236600,4520775000,28568535000,24047760000,52804795000,1236386808.5,1298934574.5,-6.1,69025.5,13366,5,25400,20300,383925000,18900,"2023-02-21T10:40:00.000Z",1676976000000,18900,18850,18900,83.3,16.7,0,0.4,0.1,,0.2,5100,30500,2789600,,576195000,480060000,96135000,
65519.1,161900,3114005000,29069385000,25955380000,55213265000,1236386808.5,1298934574.5,22.5,69025.5,13366,0.3,26500,-74700,-1406770000,18900,"2023-02-21T10:45:00.000Z",1676976300000,18900,18850,18900,20.8,79.2,0,0.4,1.5,,3.8,101200,127700,2917300,,2408470000,500850000,1907620000,
65519.1,163400,3143310000,29460610000,26317300000,55966410000,1236386808.5,1298934574.5,-0.5,69025.5,13366,1.1,20700,1500,29305000,18900,"2023-02-21T10:50:00.000Z",1676976600000,18900,18850,18850,51.9,48.1,0,0.3,0.3,,0.9,19200,39900,2957200,,753145000,391225000,361920000,
65519.1,174800,3359170000,29842350000,26483180000,56514030000,1236386808.5,1298934574.5,-3.5,69025.5,13366,2.3,20200,11400,215860000,18850,"2023-02-21T10:55:00.000Z",1676976900000,18900,18850,18900,69.7,30.3,0,0.3,0.1,,0.4,8800,29000,2986200,,547620000,381740000,165880000,
65519.1,111900,2177740000,30253280000,28075540000,58517320000,1236386808.5,1298934574.5,18.9,69025.5,13366,0.3,21800,-62900,-1181430000,18800,"2023-02-21T11:00:00.000Z",1676977200000,18850,18800,18800,20.5,79.5,0,0.3,1.2,,3.9,84700,106500,3092700,,2003290000,410930000,1592360000,
65519.1,-120300,-2181560000,30975920000,33157480000,64321900000,1236386808.5,1298934574.5,69.7,69025.5,13366,0.1,38400,-232200,-4359300000,18850,"2023-02-21T11:05:00.000Z",1676977500000,18850,18750,18850,12.4,87.6,0,0.6,3.9,,7,270600,309000,3401700,,5804580000,722640000,5081940000,
65519.1,-105500,-1902775000,31544225000,33447000000,65179725000,1236386808.5,1298934574.5,-4.5,69025.5,13366,2,30200,14800,278785000,18850,"2023-02-21T11:10:00.000Z",1676977800000,18850,18800,18850,66.2,33.8,0,0.5,0.2,,0.5,15400,45600,3447300,,857825000,568305000,289520000,
65519.1,-90500,-1619980000,32037520000,33657500000,65883520000,1236386808.5,1298934574.5,-4.5,69025.5,13366,2.3,26200,15000,282795000,18800,"2023-02-21T11:15:00.000Z",1676978100000,18850,18750,18800,70.1,29.9,0,0.4,0.2,,0.4,11200,37400,3484700,,703795000,493295000,210500000,
65519.1,-68400,-1204350000,32509400000,33713750000,66411650000,1236386808.5,1298934574.5,-6.6,69025.5,13366,8.4,25100,22100,415630000,18800,"2023-02-21T11:20:00.000Z",1676978400000,18800,18750,18750,89.3,10.7,0,0.4,0,,0.1,3000,28100,3512800,,528130000,471880000,56250000,
65519.1,-51200,-880585000,32985040000,33865625000,67039165000,1236386808.5,1298934574.5,-5.2,69025.5,13366,3.1,25300,17200,323765000,18750,"2023-02-21T11:25:00.000Z",1676978700000,18800,18750,18800,75.7,24.3,0,0.4,0.1,,0.3,8100,33400,3546200,,627515000,475640000,151875000,
65519.1,127500,2471460000,37303500000,34832040000,72324040000,1236386808.5,1298934574.5,-53.6,69025.5,13366,4.5,230300,178700,3352045000,18800,"2023-02-21T13:00:00.000Z",1676984400000,18800,18700,18750,81.7,18.3,0,3.5,0.7,,0.2,51600,281900,3828100,,5284875000,4318460000,966415000,
65519.1,141400,2735360000,38209505000,35474145000,73872150000,1236386808.5,1298934574.5,-4.2,69025.5,13366,1.4,48200,13900,263900000,18800,"2023-02-21T13:05:00.000Z",1676984700000,18800,18700,18750,58.4,41.6,0,0.7,0.5,,0.7,34300,82500,3910600,,1548110000,906005000,642105000,
65519.1,305600,5825990000,41471100000,35645110000,77304710000,1236386808.5,1298934574.5,-49.4,69025.5,13366,19,173300,164200,3090630000,18850,"2023-02-21T13:10:00.000Z",1676985000000,18850,18750,18800,95,5,0,2.6,0.1,,0.1,9100,182400,4093000,,3432560000,3261595000,170965000,
65519.1,372600,7090345000,43304315000,36213970000,79706785000,1236386808.5,1298934574.5,-20.2,69025.5,13366,3.2,97200,67000,1264355000,18900,"2023-02-21T13:15:00.000Z",1676985300000,18900,18800,18850,76.3,23.7,0,1.5,0.4,,0.3,30200,127400,4220400,,2402075000,1833215000,568860000,
65519.1,348200,6632215000,43944400000,37312185000,81445085000,1236386808.5,1298934574.5,7.3,69025.5,13366,0.6,33900,-24400,-458130000,18850,"2023-02-21T13:20:00.000Z",1676985600000,18900,18800,18900,36.8,63.2,0,0.5,0.8,,1.7,58300,92200,4312600,,1738300000,640085000,1098215000,
65519.1,301400,5753505000,44449060000,38695555000,83333115000,1236386808.5,1298934574.5,14,69025.5,13366,0.4,26800,-46800,-878710000,18800,"2023-02-21T13:25:00.000Z",1676985900000,18850,18750,18850,26.7,73.3,0,0.4,1.1,,2.7,73600,100400,4413000,,1888030000,504660000,1383370000,
65519.1,382200,7275955000,46120020000,38844065000,85152585000,1236386808.5,1298934574.5,-24.3,69025.5,13366,11.2,88700,80800,1522450000,18850,"2023-02-21T13:30:00.000Z",1676986200000,18850,18750,18800,91.8,8.2,0,1.4,0.1,,0.1,7900,96600,4509600,,1819470000,1670960000,148510000,
65519.1,425700,8096345000,47088960000,38992615000,86270075000,1236386808.5,1298934574.5,-13.1,69025.5,13366,6.5,51400,43500,820390000,18850,"2023-02-21T13:35:00.000Z",1676986500000,18900,18800,18850,86.7,13.3,0,0.8,0.1,,0.2,7900,59300,4568900,,1117490000,968940000,148550000,
65519.1,484100,9201890000,48867450000,39665560000,88721510000,1236386808.5,1298934574.5,-17.7,69025.5,13366,2.6,94100,58400,1105545000,18900,"2023-02-21T13:40:00.000Z",1676986800000,18900,18850,18900,72.5,27.5,0,1.4,0.5,,0.4,35700,129800,4698700,,2451435000,1778490000,672945000,
65519.1,494200,9393815000,49449570000,40055755000,89693825000,1236386808.5,1298934574.5,-3.1,69025.5,13366,1.5,30800,10100,191925000,18900,"2023-02-21T13:45:00.000Z",1676987100000,18900,18850,18900,59.8,40.2,0,0.5,0.3,,0.7,20700,51500,4750200,,972315000,582120000,390195000,
65519.1,414100,7884890000,49862535000,41977645000,92028680000,1236386808.5,1298934574.5,24.1,69025.5,13366,0.2,21900,-80100,-1508925000,18850,"2023-02-21T13:50:00.000Z",1676987400000,18900,18800,18850,17.7,82.3,0,0.3,1.5,,4.7,102000,123900,4874100,,2334855000,412965000,1921890000,
65519.1,323400,6181920000,50849845000,44667925000,95706270000,1236386808.5,1298934574.5,27.2,69025.5,13366,0.4,52400,-90700,-1702970000,18800,"2023-02-21T13:55:00.000Z",1676987700000,18850,18800,18850,26.8,73.2,0,0.8,2.1,,2.7,143100,195500,5069600,,3677590000,987310000,2690280000,
65519.1,304700,5831635000,51330520000,45498885000,97017905000,1236386808.5,1298934574.5,5.6,69025.5,13366,0.6,25500,-18700,-350285000,18850,"2023-02-21T14:00:00.000Z",1676988000000,18850,18800,18850,36.6,63.4,0,0.4,0.6,,1.7,44200,69700,5139300,,1311635000,480675000,830960000,
65519.1,251600,4835045000,52022155000,47187110000,99397765000,1236386808.5,1298934574.5,15.9,69025.5,13366,0.4,36700,-53100,-996590000,18800,"2023-02-21T14:05:00.000Z",1676988300000,18850,18750,18850,29,71,0,0.6,1.3,,2.4,89800,126500,5265800,,2379860000,691635000,1688225000,
65519.1,31500,711470000,52525380000,51813910000,104527790000,1236386808.5,1298934574.5,65.9,69025.5,13366,0.1,26800,-220100,-4123575000,18750,"2023-02-21T14:10:00.000Z",1676988600000,18800,18700,18800,9.8,90.2,0,0.4,3.6,,9.2,246900,273700,5539500,,5130025000,503225000,4626800000,
65519.1,-131700,-2334880000,53097785000,55432665000,108718950000,1236386808.5,1298934574.5,48.7,69025.5,13366,0.2,30600,-163200,-3046350000,18650,"2023-02-21T14:15:00.000Z",1676988900000,18750,18650,18700,13.6,86.4,0,0.5,2.8,,6.3,193800,224400,5763900,,4191160000,572405000,3618755000,
65519.1,-34100,-507560000,55745705000,56253265000,112187470000,1236386808.5,1298934574.5,-29.2,69025.5,13366,3.2,141600,97600,1827320000,18700,"2023-02-21T14:20:00.000Z",1676989200000,18700,18650,18700,76.3,23.7,0,2.2,0.6,,0.3,44000,185600,5949500,,3468520000,2647920000,820600000,
65519.1,-165800,-2958395000,58091530000,61049925000,119329955000,1236386808.5,1298934574.5,39.2,69025.5,13366,0.5,125700,-131700,-2450835000,18600,"2023-02-21T14:25:00.000Z",1676989500000,18700,18600,18700,32.8,67.2,0,1.9,3.7,,2,257400,383100,6332600,,7142485000,2345825000,4796660000,
65519.1,-164800,-2939745000,58110180000,61049925000,119348605000,1236386808.5,1298934574.5,-0.3,69025.5,13366,Infinity,1000,1000,18650000,18650,"2023-02-21T14:30:00.000Z",1676989800000,18650,18650,18650,100,0,0,0,,,0,,1000,6333600,,18650000,18650000,,
65519.1,-164800,-2939745000,58110180000,61049925000,130847125000,1236386808.5,1298934574.5,0,69025.5,13366,NaN,,0,0,18600,"2023-02-21T14:45:00.000Z",1676990700000,18600,18600,18600,0,0,100,,,46.3,NaN,,618200,6951800,618200,11498520000,,,11498520000
