"abu","acum_busd","acum_busd_val","acum_val_bu","acum_val_sd","acum_val","avg_val_bu","avg_val_sd","rbusd","asd","auk","bs","bu","bu-sd","bu-sd_val","c","date","datetime","h","l","o","pbu","psd","puk","rbu","rsd","ruk","sb","sd","sum_vol","total_vol","uk","val","val_bu","val_sd","val_uk"
95130.4,17800,216280000,1017170000,800890000,2838300000,1142626847.8,951289891.3,1.1,79828.3,11289.1,1.3,86000,17800,216280000,11950,"2023-03-08T09:15:00.000Z",1678266900000,11950,11700,11700,35.6,28.3,36.1,0.9,0.9,7.7,0.8,68200,241400,241400,87200,2838300000,1017170000,800890000,1020240000
95130.4,-22500,-260415000,1965825000,2226240000,5212305000,1142626847.8,951289891.3,-2.5,79828.3,11289.1,0.7,79700,-40300,-476695000,11850,"2023-03-08T09:20:00.000Z",1678267200000,11950,11800,11900,39.9,60.1,0,0.8,1.5,,1.5,120000,199700,441100,,2374005000,948655000,1425350000,
95130.4,44600,540700000,2897730000,2357030000,6275000000,1142626847.8,951289891.3,4.2,79828.3,11289.1,7.1,78100,67100,801115000,11950,"2023-03-08T09:25:00.000Z",1678267500000,11950,11850,11850,87.7,12.3,0,0.8,0.1,,0.1,11000,89100,530200,,1062695000,931905000,130790000,
95130.4,-4100,-38670000,2935970000,2974640000,6930850000,1142626847.8,951289891.3,-3,79828.3,11289.1,0.1,3200,-48700,-579370000,11900,"2023-03-08T09:30:00.000Z",1678267800000,11950,11900,11950,5.8,94.2,0,0,0.7,,16.2,51900,55100,585300,,655850000,38240000,617610000,
95130.4,-85400,-1002240000,3533260000,4535500000,9089000000,1142626847.8,951289891.3,-5,79828.3,11289.1,0.4,50200,-81300,-963570000,11850,"2023-03-08T09:35:00.000Z",1678268100000,11900,11800,11900,27.6,72.4,0,0.5,1.6,,2.6,131500,181700,767000,,2158150000,597290000,1560860000,
95130.4,-75000,-878115000,3866245000,4744360000,9630845000,1142626847.8,951289891.3,0.6,79828.3,11289.1,1.6,28100,10400,124125000,11800,"2023-03-08T09:40:00.000Z",1678268400000,11850,11800,11800,61.4,38.6,0,0.3,0.2,,0.6,17700,45800,812800,,541845000,332985000,208860000,
95130.4,-209100,-2458505000,3951390000,6409895000,11381525000,1142626847.8,951289891.3,-8.3,79828.3,11289.1,0.1,7200,-134100,-1580390000,11800,"2023-03-08T09:45:00.000Z",1678268700000,11850,11750,11800,4.8,95.2,0,0.1,1.8,,19.6,141300,148500,961300,,1750680000,85145000,1665535000,
95130.4,-222600,-2614770000,4542425000,7157195000,12719860000,1142626847.8,951289891.3,-0.8,79828.3,11289.1,0.8,50100,-13500,-156265000,11800,"2023-03-08T09:50:00.000Z",1678269000000,11800,11750,11750,44.1,55.9,0,0.5,0.8,,1.3,63600,113700,1075000,,1338335000,591035000,747300000,
95130.4,-211700,-2485145000,4837695000,7322840000,13181960000,1142626847.8,951289891.3,0.7,79828.3,11289.1,1.8,24900,10900,129625000,11800,"2023-03-08T09:55:00.000Z",1678269300000,11900,11800,11850,63.8,35.9,0.3,0.3,0.2,0,0.6,14000,39000,1114000,100,462100000,295270000,165645000,1185000
95130.4,-186200,-2182720000,5958695000,8141415000,15121535000,1142626847.8,951289891.3,1.6,79828.3,11289.1,1.4,95000,25500,302425000,11800,"2023-03-08T10:00:00.000Z",1678269600000,11800,11750,11800,57.8,42.2,0,1,0.9,,0.7,69500,164500,1278500,,1939575000,1121000000,818575000,
95130.4,-79500,-923270000,7356995000,8280265000,16658685000,1142626847.8,951289891.3,6.6,79828.3,11289.1,10,118500,106700,1259450000,11800,"2023-03-08T10:05:00.000Z",1678269900000,11800,11750,11800,90.9,9.1,0,1.2,0.1,,0.1,11800,130300,1408800,,1537150000,1398300000,138850000,
95130.4,-103200,-1202915000,7445510000,8648425000,17115360000,1142626847.8,951289891.3,-1.5,79828.3,11289.1,0.2,7500,-23700,-279645000,11800,"2023-03-08T10:10:00.000Z",1678270200000,11850,11800,11800,19.4,80.6,0,0.1,0.4,,4.2,31200,38700,1447500,,456675000,88515000,368160000,
95130.4,-15700,-170255000,8549990000,8720245000,18291660000,1142626847.8,951289891.3,5.4,79828.3,11289.1,15.3,93600,87500,1032660000,11800,"2023-03-08T10:15:00.000Z",1678270500000,11800,11750,11800,93.9,6.1,0,1,0.1,,0.1,6100,99700,1547200,,1176300000,1104480000,71820000,
95130.4,-63200,-730130000,9014355000,9744485000,19780265000,1142626847.8,951289891.3,-2.9,79828.3,11289.1,0.5,39300,-47500,-559875000,11850,"2023-03-08T10:20:00.000Z",1678270800000,11850,11800,11800,31.2,68.8,0,0.4,1.1,,2.2,86800,126100,1673300,,1488605000,464365000,1024240000,
95130.4,11600,158555000,10456235000,10297680000,21775340000,1142626847.8,951289891.3,4.6,79828.3,11289.1,2.6,121500,74800,888685000,11900,"2023-03-08T10:25:00.000Z",1678271100000,11900,11800,11850,72.2,27.8,0,1.3,0.6,,0.4,46700,168200,1841500,,1995075000,1441880000,553195000,
95130.4,200,22920000,10846580000,10823660000,22691665000,1142626847.8,951289891.3,-0.7,79828.3,11289.1,0.7,32800,-11400,-135635000,11900,"2023-03-08T10:30:00.000Z",1678271400000,11950,11900,11900,42.6,57.4,0,0.3,0.6,,1.3,44200,77000,1918500,,916325000,390345000,525980000,
95130.4,-3300,-18050000,11120820000,11138870000,23340365000,1142626847.8,951289891.3,-0.2,79828.3,11289.1,0.9,23100,-3500,-40970000,11850,"2023-03-08T10:35:00.000Z",1678271700000,11900,11850,11900,42.2,48.6,9.1,0.2,0.3,0.4,1.2,26600,54700,1973200,5000,648700000,274240000,315210000,59250000
95130.4,-8900,-84385000,11202585000,11286970000,23582080000,1142626847.8,951289891.3,-0.3,79828.3,11289.1,0.6,6900,-5600,-66335000,11850,"2023-03-08T10:40:00.000Z",1678272000000,11850,11800,11850,33.8,61.3,4.9,0.1,0.2,0.1,1.8,12500,20400,1993600,1000,241715000,81765000,148100000,11850000
95130.4,-4000,-26290000,11267760000,11294050000,23654335000,1142626847.8,951289891.3,0.3,79828.3,11289.1,9.2,5500,4900,58095000,11850,"2023-03-08T10:45:00.000Z",1678272300000,11850,11800,11850,90.2,9.8,0,0.1,0,,0.1,600,6100,1999700,,72255000,65175000,7080000,
95130.4,-125800,-1463380000,11349330000,12812710000,25254565000,1142626847.8,951289891.3,-7.5,79828.3,11289.1,0.1,6900,-121800,-1437090000,11800,"2023-03-08T10:50:00.000Z",1678272600000,11850,11800,11850,5.1,94.9,0,0.1,1.6,,18.7,128700,135600,2135300,,1600230000,81570000,1518660000,
95130.4,-107500,-1247440000,11719850000,12967290000,25779665000,1142626847.8,951289891.3,1.1,79828.3,11289.1,2.4,31400,18300,215940000,11800,"2023-03-08T10:55:00.000Z",1678272900000,11800,11800,11800,70.6,29.4,0,0.3,0.2,,0.4,13100,44500,2179800,,525100000,370520000,154580000,
95130.4,-126700,-1473970000,11776520000,13250490000,26119535000,1142626847.8,951289891.3,-1.2,79828.3,11289.1,0.2,4800,-19200,-226530000,11800,"2023-03-08T11:00:00.000Z",1678273200000,11850,11800,11800,16.7,83.3,0,0.1,0.3,,5,24000,28800,2208600,,339870000,56670000,283200000,
95130.4,-122700,-1426410000,12019605000,13446015000,26558145000,1142626847.8,951289891.3,0.2,79828.3,11289.1,1.2,20600,4000,47560000,11800,"2023-03-08T11:05:00.000Z",1678273500000,11850,11750,11800,55.4,44.6,0,0.2,0.2,,0.8,16600,37200,2245800,,438610000,243085000,195525000,
95130.4,-125700,-1461765000,12052650000,13514415000,26659590000,1142626847.8,951289891.3,-0.2,79828.3,11289.1,0.5,2800,-3000,-35355000,11800,"2023-03-08T11:10:00.000Z",1678273800000,11850,11750,11800,32.6,67.4,0,0,0.1,,2.1,5800,8600,2254400,,101445000,33045000,68400000,
95130.4,-133200,-1550025000,12109530000,13659555000,26861610000,1142626847.8,951289891.3,-0.5,79828.3,11289.1,0.4,4800,-7500,-88260000,11850,"2023-03-08T11:15:00.000Z",1678274100000,11850,11800,11850,28.1,71.9,0,0.1,0.2,,2.6,12300,17100,2271500,,202020000,56880000,145140000,
95130.4,-181400,-2118365000,12678710000,14797075000,28581290000,1142626847.8,951289891.3,-3,79828.3,11289.1,0.5,48200,-48200,-568340000,11800,"2023-03-08T11:20:00.000Z",1678274400000,11850,11800,11850,33.1,66.2,0.8,0.5,1.2,0.1,2,96400,145700,2417200,1100,1719680000,569180000,1137520000,12980000
95130.4,-177600,-2072915000,12962490000,15035405000,29103400000,1142626847.8,951289891.3,0.2,79828.3,11289.1,1.2,24000,3800,45450000,11850,"2023-03-08T11:25:00.000Z",1678274700000,11850,11750,11750,54.3,45.7,0,0.3,0.3,,0.8,20200,44200,2461400,,522110000,283780000,238330000,
95130.4,-339800,-3975380000,14038660000,18014040000,33159385000,1142626847.8,951289891.3,-9.9,79828.3,11289.1,0.4,91200,-162200,-1902465000,11800,"2023-03-08T13:00:00.000Z",1678280400000,11850,11750,11800,26.5,73.5,0,1,3.2,0,2.8,253400,344700,2806100,100,4055985000,1076170000,2978635000,1180000
95130.4,-353800,-4136120000,14725420000,18861540000,34693645000,1142626847.8,951289891.3,-0.8,79828.3,11289.1,0.8,58200,-14000,-160740000,11800,"2023-03-08T13:05:00.000Z",1678280700000,11800,11700,11750,44.6,55.4,0,0.6,0.9,,1.2,72200,130400,2936500,,1534260000,686760000,847500000,
95130.4,-335300,-3916025000,15758335000,19674360000,36539380000,1142626847.8,951289891.3,1.2,79828.3,11289.1,1.3,87100,18500,220095000,11850,"2023-03-08T13:10:00.000Z",1678281000000,11900,11800,11850,55.9,44.1,0,0.9,0.9,,0.8,68600,155700,3092200,,1845735000,1032915000,812820000,
95130.4,-325400,-3798070000,16484030000,20282100000,37872815000,1142626847.8,951289891.3,0.6,79828.3,11289.1,1.2,61200,9900,117955000,11800,"2023-03-08T13:15:00.000Z",1678281300000,11900,11800,11850,54.4,45.6,0,0.6,0.6,,0.8,51300,112500,3204700,,1333435000,725695000,607740000,
95130.4,-408100,-4773925000,18436805000,23210730000,42754220000,1142626847.8,951289891.3,-5.1,79828.3,11289.1,0.7,164600,-82700,-975855000,11850,"2023-03-08T13:20:00.000Z",1678281600000,11900,11800,11850,40,60,0,1.7,3.1,,1.5,247300,411900,3616600,,4881405000,1952775000,2928630000,
95130.4,34800,512365000,25178470000,24666105000,50951260000,1142626847.8,951289891.3,27.6,79828.3,11289.1,4.6,564900,442900,5286290000,12050,"2023-03-08T13:25:00.000Z",1678281900000,12100,11800,11850,82.2,17.8,0,5.9,1.5,,0.2,122000,686900,4303500,,8197040000,6741665000,1455375000,
95130.4,59700,824390000,28083790000,27259400000,56449875000,1142626847.8,951289891.3,1.6,79828.3,11289.1,1.1,239700,24900,312025000,12000,"2023-03-08T13:30:00.000Z",1678282200000,12200,12000,12050,52.7,47.3,0,2.5,2.7,,0.9,214800,454500,4758000,,5498615000,2905320000,2593295000,
95130.4,33100,507885000,29007415000,28499530000,58613630000,1142626847.8,951289891.3,-1.7,79828.3,11289.1,0.7,77100,-26600,-316505000,11950,"2023-03-08T13:35:00.000Z",1678282500000,12000,11900,12000,42.6,57.4,0,0.8,1.3,,1.3,103700,180800,4938800,,2163755000,923625000,1240130000,
95130.4,-94900,-1014340000,29521280000,30535620000,61163585000,1142626847.8,951289891.3,-8,79828.3,11289.1,0.3,43100,-128000,-1522225000,11950,"2023-03-08T13:40:00.000Z",1678282800000,11950,11900,11900,20.1,79.9,0,0.5,2.1,,4,171100,214200,5153000,,2549955000,513865000,2036090000,
95130.4,-222100,-2525745000,30198285000,32724030000,64029000000,1142626847.8,951289891.3,-7.9,79828.3,11289.1,0.3,56700,-127200,-1511405000,11950,"2023-03-08T13:45:00.000Z",1678283100000,11950,11900,11950,23.6,76.4,0,0.6,2.3,,3.2,183900,240600,5393600,,2865415000,677005000,2188410000,
95130.4,-155100,-1719110000,32697045000,34416155000,68288905000,1142626847.8,951289891.3,4.2,79828.3,11289.1,1.5,209200,67000,806635000,11950,"2023-03-08T13:50:00.000Z",1678283400000,11950,11850,11950,58.6,39.8,1.6,2.2,1.8,0.5,0.7,142200,357200,5750800,5800,4259905000,2498760000,1692125000,69020000
95130.4,460300,5805810000,42721205000,36915395000,80812305000,1142626847.8,951289891.3,39.3,79828.3,11289.1,4,823600,615400,7524920000,12350,"2023-03-08T13:55:00.000Z",1678283700000,12400,11900,11950,79.8,20.2,0,8.7,2.6,,0.3,208200,1031800,6782600,,12523400000,10024160000,2499240000,
95130.4,448300,5661670000,44766100000,39104430000,85048655000,1142626847.8,951289891.3,-0.8,79828.3,11289.1,0.9,166700,-12000,-144140000,12150,"2023-03-08T14:00:00.000Z",1678284000000,12400,12100,12400,48.2,51.7,0.1,1.8,2.2,0,1.1,178700,345600,7128200,200,4236350000,2044895000,2189035000,2420000
95130.4,552900,6940275000,46383585000,39443310000,87005020000,1142626847.8,951289891.3,6.7,79828.3,11289.1,4.8,132400,104600,1278605000,12250,"2023-03-08T14:05:00.000Z",1678284300000,12250,12150,12150,82.6,17.4,0,1.4,0.3,,0.2,27800,160200,7288400,,1956365000,1617485000,338880000,
95130.4,544400,6842690000,47639090000,40796400000,89613615000,1142626847.8,951289891.3,-0.5,79828.3,11289.1,0.9,102500,-8500,-97585000,12150,"2023-03-08T14:10:00.000Z",1678284600000,12250,12150,12200,48,52,0,1.1,1.4,,1.1,111000,213500,7501900,,2608595000,1255505000,1353090000,
95130.4,506300,6383680000,48160705000,41777025000,91115855000,1142626847.8,951289891.3,-2.4,79828.3,11289.1,0.5,42900,-38100,-459010000,12150,"2023-03-08T14:15:00.000Z",1678284900000,12200,12100,12150,34.6,65.4,0,0.5,1,,1.9,81000,123900,7625800,,1502240000,521615000,980625000,
95130.4,545500,6863595000,49448725000,42585130000,93211980000,1142626847.8,951289891.3,2.5,79828.3,11289.1,1.6,105600,39200,479915000,12200,"2023-03-08T14:20:00.000Z",1678285200000,12200,12150,12150,61.4,38.6,0,1.1,0.8,,0.6,66400,172000,7797800,,2096125000,1288020000,808105000,
95130.4,703900,8801500000,52560835000,43759335000,97498295000,1142626847.8,951289891.3,10.1,79828.3,11289.1,2.6,254600,158400,1937905000,12250,"2023-03-08T14:25:00.000Z",1678285500000,12250,12150,12200,72.6,27.4,0,2.7,1.2,,0.4,96200,350800,8148600,,4286315000,3112110000,1174205000,
95130.4,703900,8801500000,52560835000,43759335000,102607655000,1142626847.8,951289891.3,0,79828.3,11289.1,NaN,,0,0,12200,"2023-03-08T14:45:00.000Z",1678286700000,12200,12200,12200,0,0,100,,,37.1,NaN,,418800,8567400,418800,5109360000,,,5109360000
