"abu","acum_busd","acum_busd_val","acum_val_bu","acum_val_sd","acum_val","avg_val_bu","avg_val_sd","rbusd","asd","auk","bs","bu","bu-sd","bu-sd_val","c","date","datetime","h","l","o","pbu","psd","puk","rbu","rsd","ruk","sb","sd","sum_vol","total_vol","uk","val","val_bu","val_sd","val_uk"
122402.1,15800,327460000,4167215000,3839755000,21379125000,2476938829.8,3429073404.3,-0.3,170078.7,31297.9,1.1,204600,15800,327460000,20350,"2023-02-28T09:15:00.000Z",1677575700000,20450,20300,20450,19.5,18,62.4,1.7,1.1,20.9,0.9,188800,1047300,1047300,653900,21379125000,4167215000,3839755000,13372155000
122402.1,175700,3574890000,9473650000,5898760000,28744565000,2476938829.8,3429073404.3,-3.4,170078.7,31297.9,2.6,261400,159900,3247430000,20300,"2023-02-28T09:20:00.000Z",1677576000000,20350,20250,20300,72,28,0,2.1,0.6,,0.4,101500,362900,1410200,,7365440000,5306435000,2059005000,
122402.1,199700,4063565000,11668855000,7605290000,32646300000,2476938829.8,3429073404.3,-0.5,170078.7,31297.9,1.3,108100,24000,488675000,20300,"2023-02-28T09:25:00.000Z",1677576300000,20350,20250,20300,56.2,43.8,0,0.9,0.5,,0.8,84100,192200,1602400,,3901735000,2195205000,1706530000,
122402.1,46600,964970000,12805740000,11840770000,38018665000,2476938829.8,3429073404.3,3.3,170078.7,31297.9,0.3,56100,-153100,-3098595000,20250,"2023-02-28T09:30:00.000Z",1677576600000,20300,20200,20300,21.1,78.9,0,0.5,1.2,,3.7,209200,265300,1867700,,5372365000,1136885000,4235480000,
122402.1,98000,2012210000,16653280000,14641070000,44666505000,2476938829.8,3429073404.3,-1.1,170078.7,31297.9,1.4,190000,51400,1047240000,20250,"2023-02-28T09:35:00.000Z",1677576900000,20300,20200,20250,57.8,42.2,0,1.6,0.8,,0.7,138600,328600,2196300,,6647840000,3847540000,2800300000,
122402.1,-65000,-1287665000,17008530000,18296195000,48676880000,2476938829.8,3429073404.3,3.5,170078.7,31297.9,0.1,17500,-163000,-3299875000,20250,"2023-02-28T09:40:00.000Z",1677577200000,20300,20250,20300,8.8,91.2,0,0.1,1.1,,10.3,180500,198000,2394300,,4010375000,355250000,3655125000,
122402.1,126000,2592720000,22554490000,19961770000,55888415000,2476938829.8,3429073404.3,-4.1,170078.7,31297.9,3.3,273200,191000,3880385000,20300,"2023-02-28T09:45:00.000Z",1677577500000,20300,20250,20250,76.9,23.1,0,2.2,0.5,,0.3,82200,355400,2749700,,7211535000,5545960000,1665575000,
122402.1,-6000,-84670000,23453960000,23538630000,60364745000,2476938829.8,3429073404.3,2.8,170078.7,31297.9,0.3,44200,-132000,-2677390000,20350,"2023-02-28T09:50:00.000Z",1677577800000,20350,20300,20350,20.1,79.9,0,0.4,1,,4,176200,220400,2970100,,4476330000,899470000,3576860000,
122402.1,-169700,-3405435000,24408375000,27813810000,65594340000,2476938829.8,3429073404.3,3.5,170078.7,31297.9,0.2,46900,-163700,-3320765000,20300,"2023-02-28T09:55:00.000Z",1677578100000,20350,20300,20300,18.2,81.8,0,0.4,1.2,,4.5,210600,257500,3227600,,5229595000,954415000,4275180000,
122402.1,-58600,-1150085000,27910125000,29060210000,70342490000,2476938829.8,3429073404.3,-2.4,170078.7,31297.9,2.8,172500,111100,2255350000,20300,"2023-02-28T10:00:00.000Z",1677578400000,20300,20250,20300,73.7,26.3,0,1.4,0.4,,0.4,61400,233900,3461500,,4748150000,3501750000,1246400000,
122402.1,59800,1263080000,31835640000,30572560000,75780355000,2476938829.8,3429073404.3,-2.5,170078.7,31297.9,2.6,192900,118400,2413165000,20350,"2023-02-28T10:05:00.000Z",1677578700000,20350,20300,20300,72.1,27.9,0,1.6,0.4,,0.4,74500,267400,3728900,,5437865000,3925515000,1512350000,
122402.1,87600,1829215000,33001710000,31172495000,77546360000,2476938829.8,3429073404.3,-0.6,170078.7,31297.9,1.9,57300,27800,566135000,20350,"2023-02-28T10:10:00.000Z",1677579000000,20400,20300,20350,66,34,0,0.5,0.2,,0.5,29500,86800,3815700,,1766005000,1166070000,599935000,
122402.1,144000,2979815000,35313470000,32333655000,81019280000,2476938829.8,3429073404.3,-1.2,170078.7,31297.9,2,113600,56400,1150600000,20350,"2023-02-28T10:15:00.000Z",1677579300000,20350,20300,20300,66.5,33.5,0,0.9,0.3,,0.5,57200,170800,3986500,,3472920000,2311760000,1161160000,
122402.1,304600,6248550000,39402215000,33153665000,85928035000,2476938829.8,3429073404.3,-3.4,170078.7,31297.9,5,200900,160600,3268735000,20400,"2023-02-28T10:20:00.000Z",1677579600000,20400,20300,20350,83.3,16.7,0,1.6,0.2,,0.2,40300,241200,4227700,,4908755000,4088745000,820010000,
122402.1,528800,10825990000,47089815000,36263825000,96725795000,2476938829.8,3429073404.3,-4.8,170078.7,31297.9,2.5,376700,224200,4577440000,20450,"2023-02-28T10:25:00.000Z",1677579900000,20450,20350,20400,71.2,28.8,0,3.1,0.9,,0.4,152500,529200,4756900,,10797760000,7687600000,3110160000,
122402.1,644400,13193080000,51696530000,38503450000,104201995000,2476938829.8,3429073404.3,-2.5,170078.7,31297.9,2.1,225200,115600,2367090000,20450,"2023-02-28T10:30:00.000Z",1677580200000,20500,20400,20450,61.6,30,8.4,1.8,0.6,1,0.5,109600,365600,5122500,30800,7476200000,4606715000,2239625000,629860000
122402.1,622900,12758695000,54290000000,41531305000,109823320000,2476938829.8,3429073404.3,0.5,170078.7,31297.9,0.9,127000,-21500,-434385000,20450,"2023-02-28T10:35:00.000Z",1677580500000,20450,20350,20450,46.1,53.9,0,1,0.9,,1.2,148500,275500,5398000,,5621325000,2593470000,3027855000,
122402.1,424100,8709255000,54489970000,45780715000,114272700000,2476938829.8,3429073404.3,4.3,170078.7,31297.9,0,9800,-198800,-4049440000,20350,"2023-02-28T10:40:00.000Z",1677580800000,20450,20350,20400,4.5,95.5,0,0.1,1.2,,21.3,208600,218400,5616400,,4449380000,199970000,4249410000,
122402.1,334200,6880390000,54734770000,47854380000,116591165000,2476938829.8,3429073404.3,1.9,170078.7,31297.9,0.1,12000,-89900,-1828865000,20350,"2023-02-28T10:45:00.000Z",1677581100000,20400,20350,20400,10.5,89.5,0,0.1,0.6,,8.5,101900,113900,5730300,,2318465000,244800000,2073665000,
122402.1,328100,6756670000,55178435000,48421765000,117602215000,2476938829.8,3429073404.3,0.1,170078.7,31297.9,0.8,21800,-6100,-123720000,20350,"2023-02-28T10:50:00.000Z",1677581400000,20400,20300,20350,43.9,56.1,0,0.2,0.2,,1.3,27900,49700,5780000,,1011050000,443665000,567385000,
122402.1,245000,5070070000,55312745000,50242675000,119557435000,2476938829.8,3429073404.3,1.8,170078.7,31297.9,0.1,6600,-83100,-1686600000,20350,"2023-02-28T10:55:00.000Z",1677581700000,20350,20300,20300,6.9,93.1,0,0.1,0.5,,13.6,89700,96300,5876300,,1955220000,134310000,1820910000,
122402.1,149000,3122125000,55660730000,52538605000,122201350000,2476938829.8,3429073404.3,2,170078.7,31297.9,0.2,17100,-96000,-1947945000,20300,"2023-02-28T11:00:00.000Z",1677582000000,20350,20300,20350,13.1,86.9,0,0.1,0.7,,6.6,113100,130200,6006500,,2643915000,347985000,2295930000,
122402.1,-35400,-620175000,56065170000,56685345000,126752530000,2476938829.8,3429073404.3,3.9,170078.7,31297.9,0.1,19900,-184400,-3742300000,20300,"2023-02-28T11:05:00.000Z",1677582300000,20350,20250,20300,8.9,91.1,0,0.2,1.2,,10.3,204300,224200,6230700,,4551180000,404440000,4146740000,
122402.1,-211000,-4173855000,57821070000,61994925000,133818010000,2476938829.8,3429073404.3,3.7,170078.7,31297.9,0.3,86700,-175600,-3553680000,20250,"2023-02-28T11:10:00.000Z",1677582600000,20300,20200,20300,24.8,75.2,0,0.7,1.5,,3,262300,349000,6579700,,7065480000,1755900000,5309580000,
122402.1,-458400,-9170745000,58060020000,67230765000,139292800000,2476938829.8,3429073404.3,5.2,170078.7,31297.9,0,11800,-247400,-4996890000,20250,"2023-02-28T11:15:00.000Z",1677582900000,20250,20200,20250,4.4,95.6,0,0.1,1.5,,22,259200,271000,6850700,,5474790000,238950000,5235840000,
122402.1,-478800,-9580825000,58870020000,68450845000,141322880000,2476938829.8,3429073404.3,0.4,170078.7,31297.9,0.7,40000,-20400,-410080000,20200,"2023-02-28T11:20:00.000Z",1677583200000,20250,20200,20250,39.8,60.2,0,0.3,0.4,,1.5,60400,100400,6951100,,2030080000,810000000,1220080000,
122402.1,-673400,-13511350000,59029995000,72541345000,145573355000,2476938829.8,3429073404.3,4.1,170078.7,31297.9,0,7900,-194600,-3930525000,20250,"2023-02-28T11:25:00.000Z",1677583500000,20250,20200,20250,3.8,96.2,0,0.1,1.2,,25.6,202500,210400,7161500,,4250475000,159975000,4090500000,
122402.1,-708500,-14216735000,61693945000,75910680000,151606640000,2476938829.8,3429073404.3,0.7,170078.7,31297.9,0.8,131700,-35100,-705385000,20200,"2023-02-28T13:00:00.000Z",1677589200000,20250,20150,20250,44.1,55.9,0,1.1,1,,1.3,166800,298500,7460000,,6033285000,2663950000,3369335000,
122402.1,-898900,-18059060000,62230300000,80289360000,156521675000,2476938829.8,3429073404.3,4,170078.7,31297.9,0.1,26500,-190400,-3842325000,20200,"2023-02-28T13:05:00.000Z",1677589500000,20250,20150,20200,10.9,89.1,0,0.2,1.3,,8.2,216900,243400,7703400,,4915035000,536355000,4378680000,
122402.1,-978000,-19650080000,64316960000,83967040000,162286015000,2476938829.8,3429073404.3,1.7,170078.7,31297.9,0.6,103300,-79100,-1591020000,20200,"2023-02-28T13:10:00.000Z",1677589800000,20200,20150,20150,36.2,63.8,0,0.8,1.1,,1.8,182400,285700,7989100,,5764340000,2086660000,3677680000,
122402.1,-1118600,-22484900000,64636120000,87121020000,165759155000,2476938829.8,3429073404.3,3,170078.7,31297.9,0.1,15800,-140600,-2834820000,20150,"2023-02-28T13:15:00.000Z",1677590100000,20200,20150,20200,9.2,90.8,0,0.1,0.9,,9.9,156400,172200,8161300,,3473140000,319160000,3153980000,
122402.1,-1154000,-23194385000,67489775000,90684160000,172184010000,2476938829.8,3429073404.3,0.7,170078.7,31297.9,0.8,141500,-35400,-709485000,20150,"2023-02-28T13:20:00.000Z",1677590400000,20200,20100,20150,44.4,55.5,0.1,1.2,1,0,1.3,176900,318800,8480100,400,6424855000,2853655000,3563140000,8060000
122402.1,-1212500,-24366155000,69134015000,93500170000,176644260000,2476938829.8,3429073404.3,1.2,170078.7,31297.9,0.6,81600,-58500,-1171770000,20100,"2023-02-28T13:25:00.000Z",1677590700000,20150,20100,20150,36.8,63.2,0,0.7,0.8,,1.7,140100,221700,8701800,,4460250000,1644240000,2816010000,
122402.1,-1029700,-20673840000,74765520000,95439360000,184214955000,2476938829.8,3429073404.3,-3.9,170078.7,31297.9,2.9,279200,182800,3692315000,20200,"2023-02-28T13:30:00.000Z",1677591000000,20200,20100,20100,74.3,25.7,0,2.3,0.6,,0.3,96400,375600,9077400,,7570695000,5631505000,1939190000,
122402.1,-1107100,-22228140000,76947030000,99175170000,190132275000,2476938829.8,3429073404.3,1.6,170078.7,31297.9,0.6,108000,-77400,-1554300000,20150,"2023-02-28T13:35:00.000Z",1677591300000,20200,20150,20150,36.8,63.2,0,0.9,1.1,,1.7,185400,293400,9370800,,5917320000,2181510000,3735810000,
122402.1,-1184100,-23776365000,77313760000,101090125000,192413960000,2476938829.8,3429073404.3,1.6,170078.7,31297.9,0.2,18200,-77000,-1548225000,20100,"2023-02-28T13:40:00.000Z",1677591600000,20150,20100,20150,16,84,0,0.1,0.6,,5.2,95200,113400,9484200,,2281685000,366730000,1914955000,
122402.1,-1420000,-28515710000,78174070000,106689780000,198873925000,2476938829.8,3429073404.3,5,170078.7,31297.9,0.2,42800,-235900,-4739345000,20050,"2023-02-28T13:45:00.000Z",1677591900000,20150,20050,20100,13.3,86.7,0,0.3,1.6,,6.5,278700,321500,9805700,,6459965000,860310000,5599655000,
122402.1,-1624900,-32615155000,80907015000,113522170000,208539510000,2476938829.8,3429073404.3,4.3,170078.7,31297.9,0.4,136300,-204900,-4099445000,20050,"2023-02-28T13:50:00.000Z",1677592200000,20100,20000,20100,28.2,70.7,1,1.1,2,0.2,2.5,341200,482500,10288200,5000,9665585000,2732945000,6832390000,100250000
122402.1,-2390900,-47929655000,84857660000,132787315000,231755300000,2476938829.8,3429073404.3,16.1,170078.7,31297.9,0.2,197700,-766000,-15314500000,20100,"2023-02-28T13:55:00.000Z",1677592500000,20100,19900,20000,17,83,0,1.6,5.7,,4.9,963700,1161400,11449600,,23215790000,3950645000,19265145000,
122402.1,-2293200,-45965385000,87207380000,133172765000,234490470000,2476938829.8,3429073404.3,-2.1,170078.7,31297.9,6.1,116900,97700,1964270000,20050,"2023-02-28T14:00:00.000Z",1677592800000,20150,20050,20050,85.9,14.1,0,1,0.1,,0.2,19200,136100,11585700,,2735170000,2349720000,385450000,
122402.1,-2385200,-47806045000,89156280000,136962325000,240228930000,2476938829.8,3429073404.3,1.9,170078.7,31297.9,0.5,97200,-92000,-1840660000,20050,"2023-02-28T14:05:00.000Z",1677593100000,20100,20000,20050,33.9,66.1,0,0.8,1.1,,1.9,189200,286400,11872100,,5738460000,1948900000,3789560000,
122402.1,-2336300,-46818790000,93929830000,140748620000,248788775000,2476938829.8,3429073404.3,-1,170078.7,31297.9,1.3,237900,48900,987255000,20000,"2023-02-28T14:10:00.000Z",1677593400000,20100,20000,20050,55.7,44.3,0,1.9,1.1,,0.8,189000,426900,12299000,,8559845000,4773550000,3786295000,
122402.1,-2898500,-58049060000,95434445000,153483505000,263028275000,2476938829.8,3429073404.3,11.8,170078.7,31297.9,0.1,75200,-562200,-11230270000,19950,"2023-02-28T14:15:00.000Z",1677593700000,20050,19950,20000,10.6,89.4,0,0.6,3.7,,8.5,637400,712600,13011600,,14239500000,1504615000,12734885000,
122402.1,-2705200,-54153420000,105180840000,159334260000,278629415000,2476938829.8,3429073404.3,-4.1,170078.7,31297.9,1.7,486100,193300,3895640000,20150,"2023-02-28T14:20:00.000Z",1677594000000,20200,19900,19950,62.4,37.6,0,4,1.7,0,0.6,292800,779100,13790700,200,15601140000,9746395000,5850755000,3990000
122402.1,-2241500,-44764430000,116402020000,161166450000,291783785000,2476938829.8,3429073404.3,-9.9,170078.7,31297.9,6.1,554600,463700,9388990000,20100,"2023-02-28T14:25:00.000Z",1677594300000,20250,20100,20150,85.3,14,0.8,4.5,0.5,0.2,0.2,90900,650500,14441200,5000,13154370000,11221180000,1832190000,101000000
122402.1,-2240800,-44750325000,116416125000,161166450000,291797890000,2476938829.8,3429073404.3,0,170078.7,31297.9,Infinity,700,700,14105000,20150,"2023-02-28T14:30:00.000Z",1677594600000,20150,20150,20150,100,0,0,0,,,0,,700,14441900,,14105000,14105000,,
122402.1,-2240800,-44750325000,116416125000,161166450000,307311890000,2476938829.8,3429073404.3,0,170078.7,31297.9,NaN,,0,0,20000,"2023-02-28T14:45:00.000Z",1677595500000,20000,20000,20000,0,0,100,,,24.8,NaN,,775700,15217600,775700,15514000000,,,15514000000
