"abu","acum_busd","acum_busd_val","acum_val_bu","acum_val_sd","acum_val","avg_val_bu","avg_val_sd","rbusd","asd","auk","bs","bu","bu-sd","bu-sd_val","c","date","datetime","h","l","o","pbu","psd","puk","rbu","rsd","ruk","sb","sd","sum_vol","total_vol","uk","val","val_bu","val_sd","val_uk"
30165.2,35400,983375000,1121520000,138145000,1259665000,811046630.4,1070926630.4,-3.8,39750,1673.9,8.1,40400,35400,983375000,27600,"2023-02-24T09:15:00.000Z",1677230100000,27800,27550,27800,89,11,0,1.3,0.1,,0.1,5000,45400,45400,,1259665000,1121520000,138145000,
30165.2,32200,894890000,1295500000,400610000,1723760000,811046630.4,1070926630.4,0.3,39750,1673.9,0.7,6300,-3200,-88485000,27650,"2023-02-24T09:20:00.000Z",1677230400000,27700,27600,27600,37.5,56.5,6,0.2,0.2,0.6,1.5,9500,16800,62200,1000,464095000,173980000,262465000,27650000
30165.2,13200,369540000,1386745000,1017205000,2431600000,811046630.4,1070926630.4,2,39750,1673.9,0.1,3300,-19000,-525350000,27650,"2023-02-24T09:25:00.000Z",1677230700000,27650,27650,27650,12.9,87.1,0,0.1,0.6,,6.8,22300,25600,87800,,707840000,91245000,616595000,
30165.2,16200,453215000,1782300000,1329085000,3139035000,811046630.4,1070926630.4,-0.3,39750,1673.9,1.3,14300,3000,83675000,27750,"2023-02-24T09:30:00.000Z",1677231000000,27750,27600,27650,55.9,44.1,0,0.5,0.3,,0.8,11300,25600,113400,,707435000,395555000,311880000,
30165.2,24800,691865000,2129170000,1437305000,3594125000,811046630.4,1070926630.4,-0.9,39750,1673.9,3.2,12500,8600,238650000,27750,"2023-02-24T09:35:00.000Z",1677231300000,27800,27700,27700,76.2,23.8,0,0.4,0.1,,0.3,3900,16400,129800,,455090000,346870000,108220000,
30165.2,69100,1923445000,3391300000,1467855000,4886805000,811046630.4,1070926630.4,-4.7,39750,1673.9,41.3,45400,44300,1231580000,27850,"2023-02-24T09:40:00.000Z",1677231600000,27850,27750,27750,97.6,2.4,0,1.5,0,,0,1100,46500,176300,,1292680000,1262130000,30550000,
30165.2,30800,860205000,3588785000,2728580000,6345015000,811046630.4,1070926630.4,4.1,39750,1673.9,0.2,7100,-38300,-1063240000,27750,"2023-02-24T09:45:00.000Z",1677231900000,27850,27750,27850,13.5,86.5,0,0.2,1.1,,6.4,45400,52500,228800,,1458210000,197485000,1260725000,
30165.2,22200,622415000,3599870000,2977455000,6604975000,811046630.4,1070926630.4,0.9,39750,1673.9,0,400,-8600,-237790000,27700,"2023-02-24T09:50:00.000Z",1677232200000,27750,27650,27700,4.3,95.7,0,0,0.2,,22.5,9000,9400,238200,,259960000,11085000,248875000,
30165.2,9900,282350000,3854280000,3571930000,7459390000,811046630.4,1070926630.4,1.3,39750,1673.9,0.4,9200,-12300,-340065000,27650,"2023-02-24T09:55:00.000Z",1677232500000,27700,27650,27650,29.8,69.6,0.6,0.3,0.5,0.1,2.3,21500,30900,269100,200,854415000,254410000,594475000,5530000
30165.2,4900,144305000,3978910000,3834605000,7846695000,811046630.4,1070926630.4,0.5,39750,1673.9,0.5,4500,-5000,-138045000,27650,"2023-02-24T10:00:00.000Z",1677232800000,27700,27650,27650,32.1,67.9,0,0.1,0.2,,2.1,9500,14000,283100,,387305000,124630000,262675000,
30165.2,-2300,-54430000,4238490000,4292920000,8650205000,811046630.4,1070926630.4,0.8,39750,1673.9,0.6,9400,-7200,-198735000,27600,"2023-02-24T10:05:00.000Z",1677233100000,27700,27600,27700,32.3,57,10.7,0.3,0.4,1.9,1.8,16600,29100,312200,3100,803510000,259580000,458315000,85615000
30165.2,-23500,-638005000,4659410000,5297415000,10075620000,811046630.4,1070926630.4,2.2,39750,1673.9,0.4,15300,-21200,-583575000,27550,"2023-02-24T10:10:00.000Z",1677233400000,27600,27450,27600,29.5,70.5,0,0.5,0.9,,2.4,36500,51800,364000,,1425415000,420920000,1004495000,
30165.2,-10100,-267725000,5046230000,5313955000,10478980000,811046630.4,1070926630.4,-1.4,39750,1673.9,23.3,14000,13400,370280000,27650,"2023-02-24T10:15:00.000Z",1677233700000,27700,27550,27550,95.9,4.1,0,0.5,0,,0,600,14600,378600,,403360000,386820000,16540000,
30165.2,-56500,-1547930000,5065580000,6613510000,11797885000,811046630.4,1070926630.4,4.9,39750,1673.9,0,700,-46400,-1280205000,27550,"2023-02-24T10:20:00.000Z",1677234000000,27700,27550,27650,1.5,98.5,0,0,1.2,,67.3,47100,47800,426400,,1318905000,19350000,1299555000,
30165.2,-64400,-1765215000,5299760000,7064975000,12505530000,811046630.4,1070926630.4,0.8,39750,1673.9,0.5,8500,-7900,-217285000,27500,"2023-02-24T10:25:00.000Z",1677234300000,27600,27500,27550,33.1,63.8,3.1,0.3,0.4,0.5,1.9,16400,25700,452100,800,707645000,234180000,451465000,22000000
30165.2,-48400,-1325085000,5827760000,7152845000,13121400000,811046630.4,1070926630.4,-1.7,39750,1673.9,6,19200,16000,440130000,27500,"2023-02-24T10:30:00.000Z",1677234600000,27500,27450,27500,85.7,14.3,0,0.6,0.1,,0.2,3200,22400,474500,,615870000,528000000,87870000,
30165.2,-85400,-2340825000,6003770000,8344595000,14489160000,811046630.4,1070926630.4,3.9,39750,1673.9,0.1,6400,-37000,-1015740000,27400,"2023-02-24T10:35:00.000Z",1677234900000,27550,27400,27550,12.9,87.1,0,0.2,1.1,,6.8,43400,49800,524300,,1367760000,176010000,1191750000,
30165.2,-83100,-2277645000,6340730000,8618375000,15099900000,811046630.4,1070926630.4,-0.2,39750,1673.9,1.2,12300,2300,63180000,27400,"2023-02-24T10:40:00.000Z",1677235200000,27450,27350,27400,55.2,44.8,0,0.4,0.3,,0.8,10000,22300,546600,,610740000,336960000,273780000,
30165.2,-87800,-2405675000,6685970000,9091645000,15918410000,811046630.4,1070926630.4,0.5,39750,1673.9,0.7,12600,-4700,-128030000,27350,"2023-02-24T10:45:00.000Z",1677235500000,27400,27350,27400,42.1,57.9,0,0.4,0.4,,1.4,17300,29900,576500,,818510000,345240000,473270000,
30165.2,-113800,-3115095000,6732400000,9847495000,16720690000,811046630.4,1070926630.4,2.7,39750,1673.9,0.1,1700,-26000,-709420000,27300,"2023-02-24T10:50:00.000Z",1677235800000,27400,27250,27400,5.8,94.2,0,0.1,0.7,,16.3,27700,29400,605900,,802280000,46430000,755850000,
30165.2,-115100,-3150045000,6844330000,9994375000,17241100000,811046630.4,1070926630.4,0.1,39750,1673.9,0.8,4100,-1300,-34950000,27300,"2023-02-24T10:55:00.000Z",1677236100000,27300,27200,27300,21.5,28.3,50.3,0.1,0.1,5.7,1.3,5400,19100,625000,9600,520410000,111930000,146880000,261600000
30165.2,-107500,-2942020000,7142480000,10084500000,17629375000,811046630.4,1070926630.4,-0.8,39750,1673.9,3.3,10900,7600,208025000,27300,"2023-02-24T11:00:00.000Z",1677236400000,27400,27300,27300,76.8,23.2,0,0.4,0.1,,0.3,3300,14200,639200,,388275000,298150000,90125000,
30165.2,-107800,-2950055000,7259870000,10209925000,17872190000,811046630.4,1070926630.4,0,39750,1673.9,0.9,4300,-300,-8035000,27250,"2023-02-24T11:05:00.000Z",1677236700000,27300,27250,27300,48.3,51.7,0,0.1,0.1,,1.1,4600,8900,648100,,242815000,117390000,125425000,
30165.2,-129900,-3551190000,7328075000,10879265000,18609735000,811046630.4,1070926630.4,2.3,39750,1673.9,0.1,2500,-22100,-601135000,27200,"2023-02-24T11:10:00.000Z",1677237000000,27350,27200,27300,9.2,90.8,0,0.1,0.6,,9.8,24600,27100,675200,,737545000,68205000,669340000,
30165.2,-130600,-3570190000,7466800000,11036990000,18906185000,811046630.4,1070926630.4,0.1,39750,1673.9,0.9,5100,-700,-19000000,27150,"2023-02-24T11:15:00.000Z",1677237300000,27250,27150,27200,46.8,53.2,0,0.2,0.1,,1.1,5800,10900,686100,,296450000,138725000,157725000,
30165.2,-150600,-4111820000,7632600000,11744420000,19779415000,811046630.4,1070926630.4,2.1,39750,1673.9,0.2,6100,-20000,-541630000,27100,"2023-02-24T11:20:00.000Z",1677237600000,27200,27050,27200,18.9,81.1,0,0.2,0.7,,4.3,26100,32200,718300,,873230000,165800000,707430000,
30165.2,-135700,-3707565000,8050405000,11757970000,20251420000,811046630.4,1070926630.4,-1.6,39750,1673.9,30.8,15400,14900,404255000,27150,"2023-02-24T11:25:00.000Z",1677237900000,27150,27100,27100,88.5,2.9,8.6,0.5,0,0.9,0,500,17400,735700,1500,472005000,417805000,13550000,40650000
30165.2,-207000,-5629695000,9256150000,14885845000,24585040000,811046630.4,1070926630.4,7.4,39750,1673.9,0.4,44600,-71300,-1922130000,27050,"2023-02-24T13:00:00.000Z",1677243600000,27150,26900,27050,27.8,72.2,0,1.5,2.9,,2.6,115900,160500,896200,,4333620000,1205745000,3127875000,
30165.2,-301000,-8162515000,9953315000,18115830000,28512190000,811046630.4,1070926630.4,9.7,39750,1673.9,0.2,25800,-94000,-2532820000,26800,"2023-02-24T13:05:00.000Z",1677243900000,27200,26700,27050,17.7,82.3,0,0.9,3,,4.6,119800,145600,1041800,,3927150000,697165000,3229985000,
30165.2,-297300,-8061885000,10576805000,18638690000,29674640000,811046630.4,1070926630.4,-0.4,39750,1673.9,1.2,23200,3700,100630000,26900,"2023-02-24T13:10:00.000Z",1677244200000,26900,26750,26800,53.6,45,1.4,0.8,0.5,0.4,0.8,19500,43300,1085100,600,1162450000,623490000,522860000,16100000
30165.2,-222700,-6044935000,12850215000,18895150000,32204510000,811046630.4,1070926630.4,-7.8,39750,1673.9,8.9,84100,74600,2016950000,27100,"2023-02-24T13:15:00.000Z",1677244500000,27200,26950,26950,89.9,10.1,0,2.8,0.2,,0.1,9500,93600,1178700,,2529870000,2273410000,256460000,
30165.2,-250400,-6792960000,13358260000,20151220000,34089900000,811046630.4,1070926630.4,2.9,39750,1673.9,0.4,18800,-27700,-748025000,27000,"2023-02-24T13:20:00.000Z",1677244800000,27100,26900,27100,26.9,66.6,6.4,0.6,1.2,2.7,2.5,46500,69800,1248500,4500,1885390000,508045000,1256070000,121275000
30165.2,-245900,-6668545000,14168020000,20836565000,35679155000,811046630.4,1070926630.4,-0.5,39750,1673.9,1.2,30000,4500,124415000,27000,"2023-02-24T13:25:00.000Z",1677245100000,27000,26850,27000,50.8,43.2,5.9,1,0.6,2.1,0.9,25500,59000,1307500,3500,1589255000,809760000,685345000,94150000
30165.2,-204700,-5555865000,15431620000,20987485000,37279975000,811046630.4,1070926630.4,-4.3,39750,1673.9,8.4,46800,41200,1112680000,27000,"2023-02-24T13:30:00.000Z",1677245400000,27000,26950,27000,78.9,9.4,11.6,1.6,0.1,4.1,0.1,5600,59300,1366800,6900,1600820000,1263600000,150920000,186300000
30165.2,-261200,-7078025000,15590625000,22668650000,39120145000,811046630.4,1070926630.4,5.9,39750,1673.9,0.1,5900,-56500,-1522160000,26900,"2023-02-24T13:35:00.000Z",1677245700000,27000,26900,27000,8.6,91.4,0,0.2,1.6,,10.6,62400,68300,1435100,,1840170000,159005000,1681165000,
30165.2,-416300,-11235105000,16324795000,27559900000,44745565000,811046630.4,1070926630.4,16,39750,1673.9,0.2,27400,-155100,-4157080000,26750,"2023-02-24T13:40:00.000Z",1677246000000,26900,26700,26900,13.1,86.9,0,0.9,4.6,,6.7,182500,209900,1645000,,5625420000,734170000,4891250000,
30165.2,-372700,-10057030000,18175290000,28232320000,47268480000,811046630.4,1070926630.4,-4.5,39750,1673.9,2.8,68500,43600,1178075000,27050,"2023-02-24T13:45:00.000Z",1677246300000,27150,26800,26800,73.3,26.7,0,2.3,0.6,,0.4,24900,93400,1738400,,2522915000,1850495000,672420000,
30165.2,-391200,-10556070000,18486205000,29042275000,48389350000,811046630.4,1070926630.4,1.9,39750,1673.9,0.4,11500,-18500,-499040000,26950,"2023-02-24T13:50:00.000Z",1677246600000,27050,26950,27000,27.7,72.3,0,0.4,0.8,,2.6,30000,41500,1779900,,1120870000,310915000,809955000,
30165.2,-385800,-10410535000,18960530000,29371065000,49246365000,811046630.4,1070926630.4,-0.6,39750,1673.9,1.4,17600,5400,145535000,26950,"2023-02-24T13:55:00.000Z",1677246900000,27000,26950,27000,55.3,38.4,6.3,0.6,0.3,1.2,0.7,12200,31800,1811700,2000,857015000,474325000,328790000,53900000
30165.2,-388500,-10482430000,19535420000,30017850000,50468040000,811046630.4,1070926630.4,0.3,39750,1673.9,0.9,21300,-2700,-71895000,26900,"2023-02-24T14:00:00.000Z",1677247200000,27000,26900,26950,47,53,0,0.7,0.6,,1.1,24000,45300,1857000,,1221675000,574890000,646785000,
30165.2,-483800,-13041575000,19868050000,32909625000,53692445000,811046630.4,1070926630.4,9.8,39750,1673.9,0.1,12400,-95300,-2559145000,26800,"2023-02-24T14:05:00.000Z",1677247500000,26900,26750,26900,10.3,89.7,0,0.4,2.7,,8.7,107700,120100,1977100,,3224405000,332630000,2891775000,
30165.2,-478300,-12894525000,20699600000,33594125000,55208495000,811046630.4,1070926630.4,-0.6,39750,1673.9,1.2,30900,5500,147050000,26900,"2023-02-24T14:10:00.000Z",1677247800000,27000,26800,26800,54.9,45.1,0,1,0.6,,0.8,25400,56300,2033400,,1516050000,831550000,684500000,
30165.2,-771000,-20660025000,23368505000,44028530000,69374490000,811046630.4,1070926630.4,29.9,39750,1673.9,0.3,100700,-292700,-7765500000,26700,"2023-02-24T14:15:00.000Z",1677248100000,26850,26300,26850,18.9,73.7,7.5,3.3,9.9,23.8,3.9,393400,533900,2567300,39800,14165995000,2668905000,10434405000,1062685000
30165.2,-818400,-21914460000,24512245000,46426705000,72921705000,811046630.4,1070926630.4,4.8,39750,1673.9,0.5,43000,-47400,-1254435000,26700,"2023-02-24T14:20:00.000Z",1677248400000,26700,26450,26700,32.2,67.7,0.1,1.4,2.3,0.1,2.1,90400,133600,2700900,200,3547215000,1143740000,2398175000,5300000
30165.2,-833900,-22329680000,26932945000,49262625000,78266765000,811046630.4,1070926630.4,1.6,39750,1673.9,0.9,90200,-15500,-415220000,27050,"2023-02-24T14:25:00.000Z",1677248700000,27050,26700,26700,45.3,53.1,1.7,3,2.7,2,1.2,105700,199200,2900100,3300,5345060000,2420700000,2835920000,88440000
30165.2,-440900,-11954480000,37308145000,49262625000,88641965000,811046630.4,1070926630.4,-39.9,39750,1673.9,Infinity,393000,393000,10375200000,26400,"2023-02-24T14:45:00.000Z",1677249900000,26400,26400,26400,100,0,0,13,,,0,,393000,3293100,,10375200000,10375200000,,
