"abu","acum_busd","acum_busd_val","acum_val_bu","acum_val_sd","acum_val","avg_val_bu","avg_val_sd","rbusd","asd","auk","bs","bu","bu-sd","bu-sd_val","c","date","datetime","h","l","o","pbu","psd","puk","rbu","rsd","ruk","sb","sd","sum_vol","total_vol","uk","val","val_bu","val_sd","val_uk"
28276.1,-69000,-490773000,210024000,700797000,910821000,199860891.3,444744260.9,2,63076.1,1132.6,0.3,29500,-69000,-490773000,7120,"2023-03-16T09:15:00.000Z",1678958100000,7140,7100,7130,23,77,0,1,1.6,,3.3,98500,128000,128000,,910821000,210024000,700797000,
28276.1,-73100,-519858000,413550000,933408000,1346958000,199860891.3,444744260.9,0.1,63076.1,1132.6,0.9,28600,-4100,-29085000,7100,"2023-03-16T09:20:00.000Z",1678958400000,7120,7100,7120,46.7,53.3,0,1,0.5,,1.1,32700,61300,189300,,436137000,203526000,232611000,
28276.1,-168200,-1194956000,562730000,1757686000,2320416000,199860891.3,444744260.9,2.8,63076.1,1132.6,0.2,21000,-95100,-675098000,7090,"2023-03-16T09:25:00.000Z",1678958700000,7110,7090,7110,15.3,84.7,0,0.7,1.8,,5.5,116100,137100,326400,,973458000,149180000,824278000,
28276.1,-173200,-1230034000,861928000,2091962000,2953890000,199860891.3,444744260.9,0.1,63076.1,1132.6,0.9,42200,-5000,-35078000,7090,"2023-03-16T09:30:00.000Z",1678959000000,7090,7080,7090,47.2,52.8,0,1.5,0.7,,1.1,47200,89400,415800,,633474000,299198000,334276000,
28276.1,-136700,-970751000,1288535000,2259286000,3547821000,199860891.3,444744260.9,-1.1,63076.1,1132.6,2.5,60100,36500,259283000,7100,"2023-03-16T09:35:00.000Z",1678959300000,7100,7090,7090,71.8,28.2,0,2.1,0.4,,0.4,23600,83700,499500,,593931000,426607000,167324000,
28276.1,-145300,-1031561000,1404975000,2436536000,3841511000,199860891.3,444744260.9,0.2,63076.1,1132.6,0.7,16400,-8600,-60810000,7090,"2023-03-16T09:40:00.000Z",1678959600000,7100,7090,7100,39.6,60.4,0,0.6,0.4,,1.5,25000,41400,540900,,293690000,116440000,177250000,
28276.1,-97400,-691561000,2077491000,2769052000,4846543000,199860891.3,444744260.9,-1.4,63076.1,1132.6,2,94800,47900,340000000,7100,"2023-03-16T09:45:00.000Z",1678959900000,7100,7080,7090,66.9,33.1,0,3.4,0.7,,0.5,46900,141700,682600,,1005032000,672516000,332516000,
28276.1,-118300,-839770000,2105233000,2945003000,5050236000,199860891.3,444744260.9,0.6,63076.1,1132.6,0.2,3900,-20900,-148209000,7120,"2023-03-16T09:50:00.000Z",1678960200000,7120,7090,7100,13.6,86.4,0,0.1,0.4,,6.4,24800,28700,711300,,203693000,27742000,175951000,
28276.1,-145800,-1035018000,2106655000,3141673000,5248328000,199860891.3,444744260.9,0.8,63076.1,1132.6,0,200,-27500,-195248000,7100,"2023-03-16T09:55:00.000Z",1678960500000,7110,7100,7110,0.7,99.3,0,0,0.4,,138.5,27700,27900,739200,,198092000,1422000,196670000,
28276.1,-147400,-1046368000,2210325000,3256693000,5467018000,199860891.3,444744260.9,0,63076.1,1132.6,0.9,14600,-1600,-11350000,7110,"2023-03-16T10:00:00.000Z",1678960800000,7110,7100,7100,47.4,52.6,0,0.5,0.3,,1.1,16200,30800,770000,,218690000,103670000,115020000,
28276.1,-195300,-1386443000,2220990000,3607433000,5828423000,199860891.3,444744260.9,1.4,63076.1,1132.6,0,1500,-47900,-340075000,7100,"2023-03-16T10:05:00.000Z",1678961100000,7110,7100,7110,2.9,97.1,0,0.1,0.8,,32.9,49400,50900,820900,,361405000,10665000,350740000,
28276.1,-216000,-1533227000,2357500000,3890727000,6277378000,199860891.3,444744260.9,0.6,63076.1,1132.6,0.5,19200,-20700,-146784000,7110,"2023-03-16T10:10:00.000Z",1678961400000,7110,7100,7100,30.4,63.1,6.5,0.7,0.6,3.6,2.1,39900,63200,884100,4100,448955000,136510000,283294000,29151000
28276.1,-243700,-1729762000,2420149000,4149911000,6599211000,199860891.3,444744260.9,0.8,63076.1,1132.6,0.2,8800,-27700,-196535000,7100,"2023-03-16T10:15:00.000Z",1678961700000,7130,7100,7110,19.4,80.6,0,0.3,0.6,,4.1,36500,45300,929400,,321833000,62649000,259184000,
28276.1,-264300,-1876022000,2432219000,4308241000,6769611000,199860891.3,444744260.9,0.6,63076.1,1132.6,0.1,1700,-20600,-146260000,7100,"2023-03-16T10:20:00.000Z",1678962000000,7100,7100,7100,7.1,92.9,0,0.1,0.4,,13.1,22300,24000,953400,,170400000,12070000,158330000,
28276.1,-259100,-1839052000,2512449000,4351501000,6893101000,199860891.3,444744260.9,-0.2,63076.1,1132.6,1.9,11300,5200,36970000,7090,"2023-03-16T10:25:00.000Z",1678962300000,7100,7090,7100,64.9,35.1,0,0.4,0.1,,0.5,6100,17400,970800,,123490000,80230000,43260000,
28276.1,-243500,-1728292000,2623919000,4352211000,7005281000,199860891.3,444744260.9,-0.5,63076.1,1132.6,157,15700,15600,110760000,7100,"2023-03-16T10:30:00.000Z",1678962600000,7100,7100,7100,99.4,0.6,0,0.6,0,,0,100,15800,986600,,112180000,111470000,710000,
28276.1,-267600,-1899197000,2626759000,4525956000,7181866000,199860891.3,444744260.9,0.7,63076.1,1132.6,0,400,-24100,-170905000,7090,"2023-03-16T10:35:00.000Z",1678962900000,7100,7090,7100,1.6,98.4,0,0,0.4,,61.3,24500,24900,1011500,,176585000,2840000,173745000,
28276.1,-457000,-3240450000,2717639000,5958089000,8704879000,199860891.3,444744260.9,5.5,63076.1,1132.6,0.1,12800,-189400,-1341253000,7070,"2023-03-16T10:40:00.000Z",1678963200000,7100,7070,7090,6,94,0,0.5,3.2,,15.8,202200,215000,1226500,,1523013000,90880000,1432133000,
28276.1,-461200,-3270057000,2797064000,6067121000,8893336000,199860891.3,444744260.9,0.1,63076.1,1132.6,0.7,11200,-4200,-29607000,7090,"2023-03-16T10:45:00.000Z",1678963500000,7100,7070,7070,42.1,57.9,0,0.4,0.2,,1.4,15400,26600,1253100,,188457000,79425000,109032000,
28276.1,-478400,-3391990000,2911760000,6303750000,9244661000,199860891.3,444744260.9,0.5,63076.1,1132.6,0.5,16200,-17200,-121933000,7080,"2023-03-16T10:50:00.000Z",1678963800000,7090,7080,7090,32.7,67.3,0,0.6,0.5,,2.1,33400,49600,1302700,,351325000,114696000,236629000,
28276.1,-444600,-3152323000,3173382000,6325705000,9528238000,199860891.3,444744260.9,-1,63076.1,1132.6,11.9,36900,33800,239667000,7090,"2023-03-16T10:55:00.000Z",1678964100000,7100,7080,7080,92.3,7.8,0,1.3,0,,0.1,3100,40000,1342700,,283577000,261622000,21955000,
28276.1,-428200,-3036047000,3407352000,6443399000,9879902000,199860891.3,444744260.9,-0.5,63076.1,1132.6,2,33000,16400,116276000,7090,"2023-03-16T11:00:00.000Z",1678964400000,7090,7090,7090,66.5,33.5,0,1.2,0.3,,0.5,16600,49600,1392300,,351664000,233970000,117694000,
28276.1,-426000,-3020449000,3542771000,6563220000,10135142000,199860891.3,444744260.9,-0.1,63076.1,1132.6,1.1,19100,2200,15598000,7090,"2023-03-16T11:05:00.000Z",1678964700000,7090,7090,7090,53.1,46.9,0,0.7,0.3,,0.9,16900,36000,1428300,,255240000,135419000,119821000,
28276.1,-468900,-3324396000,3543479000,6867875000,10440505000,199860891.3,444744260.9,1.2,63076.1,1132.6,0,100,-42900,-303947000,7080,"2023-03-16T11:10:00.000Z",1678965000000,7090,7080,7090,0.2,99.8,0,0,0.7,,430,43000,43100,1471400,,305363000,708000,304655000,
28276.1,-446200,-3163578000,3786425000,6950003000,10765579000,199860891.3,444744260.9,-0.7,63076.1,1132.6,3,34300,22700,160818000,7080,"2023-03-16T11:15:00.000Z",1678965300000,7090,7080,7080,74.7,25.3,0,1.2,0.2,,0.3,11600,45900,1517300,,325074000,242946000,82128000,
28276.1,-502500,-3561375000,4057077000,7618452000,11704680000,199860891.3,444744260.9,1.6,63076.1,1132.6,0.4,38200,-56300,-397797000,7070,"2023-03-16T11:20:00.000Z",1678965600000,7090,7070,7070,28.8,71.2,0,1.4,1.5,,2.5,94500,132700,1650000,,939101000,270652000,668449000,
28276.1,-442800,-3138698000,4504533000,7643231000,12176915000,199860891.3,444744260.9,-1.7,63076.1,1132.6,18.1,63200,59700,422677000,7080,"2023-03-16T11:25:00.000Z",1678965900000,7080,7070,7080,94.8,5.2,0,2.2,0.1,,0.1,3500,66700,1716700,,472235000,447456000,24779000,
28276.1,-504400,-3573648000,4612825000,8186473000,12842589000,199860891.3,444744260.9,1.8,63076.1,1132.6,0.2,15300,-61600,-434950000,7060,"2023-03-16T13:00:00.000Z",1678971600000,7080,7060,7080,16.2,81.6,2.1,0.5,1.2,1.8,5,76900,94200,1810900,2000,665674000,108292000,543242000,14140000
28276.1,-514400,-3644033000,4793561000,8437594000,13274446000,199860891.3,444744260.9,0.3,63076.1,1132.6,0.7,25600,-10000,-70385000,7060,"2023-03-16T13:05:00.000Z",1678971900000,7060,7050,7060,41.8,58.2,0,0.9,0.6,,1.4,35600,61200,1872100,,431857000,180736000,251121000,
28276.1,-511000,-3619970000,5036484000,8656454000,13736229000,199860891.3,444744260.9,-0.1,63076.1,1132.6,1.1,34400,3400,24063000,7070,"2023-03-16T13:10:00.000Z",1678972200000,7070,7060,7060,52.6,47.4,0,1.2,0.5,,0.9,31000,65400,1937500,,461783000,242923000,218860000,
28276.1,-536400,-3799283000,5044261000,8843544000,13931096000,199860891.3,444744260.9,0.7,63076.1,1132.6,0,1100,-25400,-179313000,7060,"2023-03-16T13:15:00.000Z",1678972500000,7070,7060,7070,4,96,0,0,0.4,,24.1,26500,27600,1965100,,194867000,7777000,187090000,
28276.1,-562700,-3984840000,5129808000,9114648000,14287747000,199860891.3,444744260.9,0.8,63076.1,1132.6,0.3,12100,-26300,-185557000,7070,"2023-03-16T13:20:00.000Z",1678972800000,7070,7060,7060,24,76,0,0.4,0.6,,3.2,38400,50500,2015600,,356651000,85547000,271104000,
28276.1,-676500,-4786619000,5226330000,10012949000,15282570000,199860891.3,444744260.9,3.3,63076.1,1132.6,0.1,13700,-113800,-801779000,7040,"2023-03-16T13:25:00.000Z",1678973100000,7060,7040,7060,9.7,90.3,0,0.5,2,,9.3,127500,141200,2156800,,994823000,96522000,898301000,
28276.1,-786600,-5561023000,5328415000,10889438000,16261144000,199860891.3,444744260.9,3.2,63076.1,1132.6,0.1,14500,-110100,-774404000,7040,"2023-03-16T13:30:00.000Z",1678973400000,7050,7030,7040,10.4,89.6,0,0.5,2,,8.6,124600,139100,2295900,,978574000,102085000,876489000,
28276.1,-728000,-5148854000,5922721000,11071575000,17058677000,199860891.3,444744260.9,-1.7,63076.1,1132.6,3.3,84500,58600,412169000,7050,"2023-03-16T13:35:00.000Z",1678973700000,7050,7030,7040,74.5,22.8,2.6,3,0.4,2.6,0.3,25900,113400,2409300,3000,797533000,594306000,182137000,21090000
28276.1,-785600,-5553961000,6032585000,11586546000,17683512000,199860891.3,444744260.9,1.7,63076.1,1132.6,0.2,15600,-57600,-405107000,7040,"2023-03-16T13:40:00.000Z",1678974000000,7050,7030,7050,17.6,82.4,0,0.6,1.2,,4.7,73200,88800,2498100,,624835000,109864000,514971000,
28276.1,-742200,-5247792000,6478850000,11726642000,18269873000,199860891.3,444744260.9,-1.3,63076.1,1132.6,3.2,63300,43400,306169000,7050,"2023-03-16T13:45:00.000Z",1678974300000,7050,7040,7040,76.1,23.9,0,2.2,0.3,,0.3,19900,83200,2581300,,586361000,446265000,140096000,
28276.1,-653000,-4618573000,7324649000,11943222000,19332252000,199860891.3,444744260.9,-2.6,63076.1,1132.6,3.9,119900,89200,629219000,7060,"2023-03-16T13:50:00.000Z",1678974600000,7060,7050,7050,79.6,20.4,0,4.2,0.5,,0.3,30700,150600,2731900,,1062379000,845799000,216580000,
28276.1,-863900,-6102136000,7441049000,13543185000,21050025000,199860891.3,444744260.9,6.1,63076.1,1132.6,0.1,16500,-210900,-1483563000,7020,"2023-03-16T13:55:00.000Z",1678974900000,7060,7020,7060,6.8,93.2,0.1,0.6,3.6,0.2,13.8,227400,244100,2976000,200,1717773000,116400000,1599963000,1410000
28276.1,-1041700,-7349032000,7483193000,14832225000,22381209000,199860891.3,444744260.9,5.1,63076.1,1132.6,0,6000,-177800,-1246896000,7030,"2023-03-16T14:00:00.000Z",1678975200000,7030,7000,7030,3.2,96.8,0,0.2,2.9,,30.6,183800,189800,3165800,,1331184000,42144000,1289040000,
28276.1,-1056400,-7452111000,7780956000,15233067000,23079814000,199860891.3,444744260.9,0.4,63076.1,1132.6,0.7,42400,-14700,-103079000,7020,"2023-03-16T14:05:00.000Z",1678975500000,7030,7020,7020,42.6,57.4,0,1.5,0.9,,1.3,57100,99500,3265300,,698605000,297763000,400842000,
28276.1,-967900,-6829265000,8581006000,15410271000,24057068000,199860891.3,444744260.9,-2.5,63076.1,1132.6,4.5,113700,88500,622846000,7050,"2023-03-16T14:10:00.000Z",1678975800000,7060,7020,7020,81.9,18.1,0,4,0.4,,0.2,25200,138900,3404200,,977254000,800050000,177204000,
28276.1,-1340000,-9436690000,8719537000,18156227000,26941555000,199860891.3,444744260.9,10.6,63076.1,1132.6,0.1,19700,-372100,-2607425000,7010,"2023-03-16T14:15:00.000Z",1678976100000,7060,7000,7060,4.8,95.2,0,0.7,6.2,,19.9,391800,411500,3815700,,2884487000,138531000,2745956000,
28276.1,-1534600,-10799564000,9125999000,19925563000,29117353000,199860891.3,444744260.9,5.6,63076.1,1132.6,0.2,57900,-194600,-1362874000,7030,"2023-03-16T14:20:00.000Z",1678976400000,7040,7000,7010,18.7,81.3,0,2,4,,4.4,252500,310400,4126100,,2175798000,406462000,1769336000,
28276.1,-1600800,-11264635000,9193601000,20458236000,29717628000,199860891.3,444744260.9,1.9,63076.1,1132.6,0.1,9600,-66200,-465071000,7020,"2023-03-16T14:25:00.000Z",1678976700000,7050,7020,7020,11.2,88.8,0,0.3,1.2,,7.9,75800,85400,4211500,,600275000,67602000,532673000,
28276.1,-1600800,-11264635000,9193601000,20458236000,30019368000,199860891.3,444744260.9,0,63076.1,1132.6,NaN,,0,0,7050,"2023-03-16T14:45:00.000Z",1678977900000,7050,7050,7050,0,0,100,,,37.8,NaN,,42800,4254300,42800,301740000,,,301740000
