"abu","acum_busd","acum_busd_val","acum_val_bu","acum_val_sd","acum_val","avg_val_bu","avg_val_sd","rbusd","asd","auk","bs","bu","bu-sd","bu-sd_val","c","date","datetime","h","l","o","pbu","psd","puk","rbu","rsd","ruk","sb","sd","sum_vol","total_vol","uk","val","val_bu","val_sd","val_uk"
82663,359400,5933700000,7204535000,1270835000,8480300000,1364489347.8,1509165217.4,-41,91813,11243.5,5.6,436800,359400,5933700000,16500,"2023-03-13T09:15:00.000Z",1678698900000,16500,16350,16500,84.9,15,0.1,5.3,0.8,0,0.2,77400,514500,514500,300,8480300000,7204535000,1270835000,4930000
82663,260700,4311730000,7982520000,3670790000,11661530000,1364489347.8,1509165217.4,11.2,91813,11243.5,0.3,47200,-98700,-1621970000,16400,"2023-03-13T09:20:00.000Z",1678699200000,16500,16400,16500,24.4,75.5,0.1,0.6,1.6,0,3.1,145900,193300,707800,200,3181230000,777985000,2399955000,3290000
82663,182700,3032835000,8321450000,5288615000,13618285000,1364489347.8,1509165217.4,8.8,91813,11243.5,0.2,20600,-78000,-1278895000,16400,"2023-03-13T09:25:00.000Z",1678699500000,16500,16400,16450,17.3,82.7,0,0.2,1.1,,4.8,98600,119200,827000,,1956755000,338930000,1617825000,
82663,213400,3537940000,9588125000,6050185000,15646530000,1364489347.8,1509165217.4,-3.5,91813,11243.5,1.7,77000,30700,505105000,16450,"2023-03-13T09:30:00.000Z",1678699800000,16500,16400,16450,62.4,37.6,0,0.9,0.5,,0.6,46300,123300,950300,,2028245000,1266675000,761570000,
82663,156000,2595195000,10237900000,7642705000,17888825000,1364489347.8,1509165217.4,6.5,91813,11243.5,0.4,39500,-57400,-942745000,16450,"2023-03-13T09:35:00.000Z",1678700100000,16450,16400,16450,29,71,0,0.5,1.1,,2.5,96900,136400,1086700,,2242295000,649775000,1592520000,
82663,-58000,-905645000,10907455000,11813100000,22728775000,1364489347.8,1509165217.4,24.2,91813,11243.5,0.2,40800,-214000,-3500840000,16300,"2023-03-13T09:40:00.000Z",1678700400000,16450,16300,16450,13.8,86.2,0,0.5,2.8,,6.2,254800,295600,1382300,,4839950000,669555000,4170395000,
82663,-278700,-4485970000,11530295000,16016265000,27554780000,1364489347.8,1509165217.4,24.7,91813,11243.5,0.1,38300,-220700,-3580325000,16250,"2023-03-13T09:45:00.000Z",1678700700000,16350,16200,16300,12.9,87.1,0,0.5,2.8,,6.8,259000,297300,1679600,,4826005000,622840000,4203165000,
82663,-363800,-5859295000,13148915000,19008210000,32165345000,1364489347.8,1509165217.4,9.5,91813,11243.5,0.5,99400,-85100,-1373325000,16200,"2023-03-13T09:50:00.000Z",1678701000000,16300,16200,16250,35,65,0,1.2,2,,1.9,184500,283900,1963500,,4610565000,1618620000,2991945000,
82663,-393800,-6345700000,13726850000,20072550000,33807620000,1364489347.8,1509165217.4,3.4,91813,11243.5,0.5,35500,-30000,-486405000,16300,"2023-03-13T09:55:00.000Z",1678701300000,16300,16200,16250,35.1,64.9,0,0.4,0.7,,1.8,65500,101000,2064500,,1642275000,577935000,1064340000,
82663,-446500,-7201165000,14449260000,21650425000,36107905000,1364489347.8,1509165217.4,5.9,91813,11243.5,0.5,44400,-52700,-855465000,16250,"2023-03-13T10:00:00.000Z",1678701600000,16300,16250,16300,31.4,68.6,0,0.5,1.1,,2.2,97100,141500,2206000,,2300285000,722410000,1577875000,
82663,-443000,-7143525000,14939150000,22082675000,37030045000,1364489347.8,1509165217.4,-0.4,91813,11243.5,1.1,30100,3500,57640000,16300,"2023-03-13T10:05:00.000Z",1678701900000,16300,16250,16250,53.1,46.9,0,0.4,0.3,,0.9,26600,56700,2262700,,922140000,489890000,432250000,
82663,-389800,-6274095000,16587355000,22861450000,39457025000,1364489347.8,1509165217.4,-6,91813,11243.5,2.1,101100,53200,869430000,16350,"2023-03-13T10:10:00.000Z",1678702200000,16350,16250,16250,67.9,32.1,0,1.2,0.5,,0.5,47900,149000,2411700,,2426980000,1648205000,778775000,
82663,-487900,-7870700000,16983870000,24854570000,41846660000,1364489347.8,1509165217.4,11,91813,11243.5,0.2,24300,-98100,-1596605000,16300,"2023-03-13T10:15:00.000Z",1678702500000,16350,16250,16350,16.6,83.4,0,0.3,1.3,,5,122400,146700,2558400,,2389635000,396515000,1993120000,
82663,-459800,-7411870000,17501375000,24913245000,42422840000,1364489347.8,1509165217.4,-3.2,91813,11243.5,8.8,31700,28100,458830000,16350,"2023-03-13T10:20:00.000Z",1678702800000,16350,16250,16300,89.8,10.2,0,0.4,0,,0.1,3600,35300,2593700,,576180000,517505000,58675000,
82663,-293400,-4688880000,20273330000,24962210000,45243760000,1364489347.8,1509165217.4,-18.8,91813,11243.5,56.5,169400,166400,2722990000,16400,"2023-03-13T10:25:00.000Z",1678703100000,16400,16300,16350,98.3,1.7,0,2,0,,0,3000,172400,2766100,,2820920000,2771955000,48965000,
82663,-178900,-2807470000,22384340000,25191810000,47584370000,1364489347.8,1509165217.4,-13,91813,11243.5,9.2,128500,114500,1881410000,16450,"2023-03-13T10:30:00.000Z",1678703400000,16450,16400,16400,90.2,9.8,0,1.6,0.2,,0.1,14000,142500,2908600,,2340610000,2111010000,229600000,
82663,100,146035000,25341140000,25195105000,50544465000,1364489347.8,1509165217.4,-20.4,91813,11243.5,896,179200,179000,2953505000,16550,"2023-03-13T10:35:00.000Z",1678703700000,16550,16450,16450,99.9,0.1,0,2.2,0,,0,200,179400,3088000,,2960095000,2956800000,3295000,
82663,59000,1122010000,26613060000,25491050000,52112330000,1364489347.8,1509165217.4,-6.7,91813,11243.5,4.3,76800,58900,975975000,16600,"2023-03-13T10:40:00.000Z",1678704000000,16600,16500,16550,81.1,18.9,0,0.9,0.2,,0.2,17900,94700,3182700,,1567865000,1271920000,295945000,
82663,-111000,-1687295000,27658670000,29345965000,57012855000,1364489347.8,1509165217.4,19.4,91813,11243.5,0.3,63300,-170000,-2809305000,16450,"2023-03-13T10:45:00.000Z",1678704300000,16600,16450,16600,21.3,78.7,0,0.8,2.5,,3.7,233300,296600,3479300,,4900525000,1045610000,3854915000,
82663,-126800,-1947090000,27696620000,29643710000,57348550000,1364489347.8,1509165217.4,1.8,91813,11243.5,0.1,2300,-15800,-259795000,16450,"2023-03-13T10:50:00.000Z",1678704600000,16500,16450,16500,11.3,88.7,0,0,0.2,,7.9,18100,20400,3499700,,335695000,37950000,297745000,
82663,-167000,-2607960000,28163855000,30771815000,58943890000,1364489347.8,1509165217.4,4.6,91813,11243.5,0.4,28400,-40200,-660870000,16450,"2023-03-13T10:55:00.000Z",1678704900000,16500,16400,16450,29.3,70.7,0,0.3,0.7,,2.4,68600,97000,3596700,,1595340000,467235000,1128105000,
82663,-133500,-2056875000,28752765000,30809640000,59570625000,1364489347.8,1509165217.4,-3.8,91813,11243.5,15.6,35800,33500,551085000,16450,"2023-03-13T11:00:00.000Z",1678705200000,16450,16400,16450,94,6,0,0.4,0,,0.1,2300,38100,3634800,,626735000,588910000,37825000,
82663,-24100,-251570000,30625515000,30877085000,61510820000,1364489347.8,1509165217.4,-12.5,91813,11243.5,27.7,113500,109400,1805305000,16500,"2023-03-13T11:05:00.000Z",1678705500000,16500,16450,16500,96.5,3.5,0,1.4,0,,0,4100,117600,3752400,,1940195000,1872750000,67445000,
82663,-22700,-225250000,32056025000,32281275000,64345520000,1364489347.8,1509165217.4,-0.2,91813,11243.5,1,86300,1400,26320000,16600,"2023-03-13T11:10:00.000Z",1678705800000,16600,16500,16500,50.4,49.6,0,1,0.9,,1,84900,171200,3923600,,2834700000,1430510000,1404190000,
82663,117100,2096175000,34816605000,32720430000,67545255000,1364489347.8,1509165217.4,-16,91813,11243.5,6.3,166300,139800,2321425000,16600,"2023-03-13T11:15:00.000Z",1678706100000,16600,16550,16550,86.3,13.7,0,2,0.3,,0.2,26500,192800,4116400,,3199735000,2760580000,439155000,
82663,41800,846995000,35066235000,34219240000,69293695000,1364489347.8,1509165217.4,8.6,91813,11243.5,0.2,15000,-75300,-1249180000,16600,"2023-03-13T11:20:00.000Z",1678706400000,16650,16550,16550,14.2,85.8,0,0.2,1,,6,90300,105300,4221700,,1748440000,249630000,1498810000,
82663,12300,358365000,35375500000,35017135000,70400855000,1364489347.8,1509165217.4,3.4,91813,11243.5,0.4,18600,-29500,-488630000,16550,"2023-03-13T11:25:00.000Z",1678706700000,16650,16550,16600,27.9,72.1,0,0.2,0.5,,2.6,48100,66700,4288400,,1107160000,309265000,797895000,
82663,-149300,-2313400000,35961375000,38274775000,74244370000,1364489347.8,1509165217.4,18.5,91813,11243.5,0.2,35300,-161600,-2671765000,16500,"2023-03-13T13:00:00.000Z",1678712400000,16600,16500,16550,15.2,84.8,0,0.4,2.1,,5.6,196900,232200,4520600,,3843515000,585875000,3257640000,
82663,-147700,-2283365000,37164560000,39447925000,76620705000,1364489347.8,1509165217.4,-0.2,91813,11243.5,1,72700,1600,30035000,16500,"2023-03-13T13:05:00.000Z",1678712700000,16550,16500,16500,50.6,49.4,0,0.9,0.8,,1,71100,143800,4664400,,2376335000,1203185000,1173150000,
82663,-114200,-1728940000,37806700000,39535640000,77350560000,1364489347.8,1509165217.4,-3.8,91813,11243.5,7.3,38800,33500,554425000,16550,"2023-03-13T13:10:00.000Z",1678713000000,16550,16550,16550,88,12,0,0.5,0.1,,0.1,5300,44100,4708500,,729855000,642140000,87715000,
82663,-104100,-1559135000,38714635000,40273770000,78996625000,1364489347.8,1509165217.4,-1.2,91813,11243.5,1.2,54700,10100,169805000,16550,"2023-03-13T13:15:00.000Z",1678713300000,16600,16550,16550,55.1,44.9,0,0.7,0.5,,0.8,44600,99300,4807800,,1646065000,907935000,738130000,
82663,-231500,-3660715000,39186670000,42847385000,82042275000,1364489347.8,1509165217.4,14.5,91813,11243.5,0.2,28600,-127400,-2101580000,16500,"2023-03-13T13:20:00.000Z",1678713600000,16600,16450,16550,15.5,84.5,0,0.3,1.7,,5.5,156000,184600,4992400,,3045650000,472035000,2573615000,
82663,-278900,-4437445000,40176670000,44614115000,84799005000,1364489347.8,1509165217.4,5.4,91813,11243.5,0.6,60000,-47400,-776730000,16450,"2023-03-13T13:25:00.000Z",1678713900000,16500,16450,16500,35.8,64.2,0,0.7,1.2,,1.8,107400,167400,5159800,,2756730000,990000000,1766730000,
82663,-561600,-9076075000,40578525000,49654600000,90242985000,1364489347.8,1509165217.4,32.1,91813,11243.5,0.1,24500,-282700,-4638630000,16400,"2023-03-13T13:30:00.000Z",1678714200000,16450,16350,16450,7.4,92.6,0,0.3,3.3,0,12.5,307200,331800,5491600,100,5443980000,401855000,5040485000,1640000
82663,-588800,-9521045000,41957105000,51478150000,93445115000,1364489347.8,1509165217.4,3.1,91813,11243.5,0.8,84000,-27200,-444970000,16400,"2023-03-13T13:35:00.000Z",1678714500000,16450,16350,16400,43,57,0,1,1.2,,1.3,111200,195200,5686800,,3202130000,1378580000,1823550000,
82663,-563000,-9097190000,42919890000,52017080000,94946830000,1364489347.8,1509165217.4,-2.9,91813,11243.5,1.8,58700,25800,423855000,16400,"2023-03-13T13:40:00.000Z",1678714800000,16450,16350,16400,64.1,35.9,0,0.7,0.4,,0.6,32900,91600,5778400,,1501715000,962785000,538930000,
82663,-530000,-8551845000,44078065000,52629910000,96717835000,1364489347.8,1509165217.4,-3.8,91813,11243.5,1.9,70300,33000,545345000,16500,"2023-03-13T13:45:00.000Z",1678715100000,16500,16400,16450,65.3,34.7,0,0.9,0.4,,0.5,37300,107600,5886000,,1771005000,1158175000,612830000,
82663,-17600,-20250000,53013700000,53033950000,106057510000,1364489347.8,1509165217.4,-59,91813,11243.5,22,536800,512400,8531595000,16750,"2023-03-13T13:50:00.000Z",1678715400000,16750,16500,16500,95.7,4.3,0,6.5,0.3,,0,24400,561200,6447200,,9339675000,8935635000,404040000,
82663,44100,1018930000,55865900000,54846970000,110722730000,1364489347.8,1509165217.4,-7.2,91813,11243.5,1.6,170300,61700,1039180000,16650,"2023-03-13T13:55:00.000Z",1678715700000,16800,16650,16750,61.1,38.9,0,2.1,1.2,,0.6,108600,278900,6726100,,4665220000,2852200000,1813020000,
82663,-78000,-1006450000,56653220000,57659670000,114322750000,1364489347.8,1509165217.4,14,91813,11243.5,0.3,47400,-122100,-2025380000,16550,"2023-03-13T14:00:00.000Z",1678716000000,16700,16550,16700,21.9,78.1,0,0.6,1.8,,3.6,169500,216900,6943000,,3600020000,787320000,2812700000,
82663,-107400,-1491980000,57590660000,59082640000,116683160000,1364489347.8,1509165217.4,3.4,91813,11243.5,0.7,56600,-29400,-485530000,16550,"2023-03-13T14:05:00.000Z",1678716300000,16600,16500,16550,39.7,60.3,0,0.7,0.9,,1.5,86000,142600,7085600,,2360410000,937440000,1422970000,
82663,-373600,-5884290000,57956310000,63840600000,121806770000,1364489347.8,1509165217.4,30.4,91813,11243.5,0.1,22200,-266200,-4392310000,16450,"2023-03-13T14:10:00.000Z",1678716600000,16600,16400,16550,7.1,92.9,0,0.3,3.1,,13,288400,310600,7396200,,5123610000,365650000,4757960000,
82663,-440200,-6976135000,59238090000,66214225000,125462175000,1364489347.8,1509165217.4,7.5,91813,11243.5,0.5,78000,-66600,-1091845000,16400,"2023-03-13T14:15:00.000Z",1678716900000,16500,16350,16400,35,65,0,0.9,1.6,,1.9,144600,222600,7618800,,3655405000,1281780000,2373625000,
82663,-352200,-5522165000,61957890000,67480055000,129447805000,1364489347.8,1509165217.4,-10,91813,11243.5,2.2,164500,88000,1453970000,16550,"2023-03-13T14:20:00.000Z",1678717200000,16650,16400,16450,68.3,31.7,0,2,0.8,,0.5,76500,241000,7859800,,3985630000,2719800000,1265830000,
82663,-420900,-6655090000,62766510000,69421600000,132197970000,1364489347.8,1509165217.4,7.8,91813,11243.5,0.4,49000,-68700,-1132925000,16450,"2023-03-13T14:25:00.000Z",1678717500000,16550,16450,16550,29.4,70.6,0,0.6,1.3,,2.4,117700,166700,8026500,,2750165000,808620000,1941545000,
82663,-420900,-6655090000,62766510000,69421600000,140670210000,1364489347.8,1509165217.4,0,91813,11243.5,NaN,,0,0,16400,"2023-03-13T14:45:00.000Z",1678718700000,16400,16400,16400,0,0,100,,,45.9,NaN,,516600,8543100,516600,8472240000,,,8472240000
