"abu","acum_busd","acum_busd_val","acum_val_bu","acum_val_sd","acum_val","avg_val_bu","avg_val_sd","rbusd","asd","auk","bs","bu","bu-sd","bu-sd_val","c","date","datetime","h","l","o","pbu","psd","puk","rbu","rsd","ruk","sb","sd","sum_vol","total_vol","uk","val","val_bu","val_sd","val_uk"
23617.4,34900,850060000,1479330000,629270000,2108600000,566029347.8,1370177173.9,-1.1,57419.6,167.4,2.3,60800,34900,850060000,24250,"2023-03-17T09:15:00.000Z",1679044500000,24400,24250,24300,70.1,29.9,0,2.6,0.5,,0.4,25900,86700,86700,,2108600000,1479330000,629270000,
23617.4,13000,320365000,1940755000,1620390000,3561145000,566029347.8,1370177173.9,0.7,57419.6,167.4,0.5,19000,-21900,-529695000,24200,"2023-03-17T09:20:00.000Z",1679044800000,24300,24200,24300,31.7,68.3,0,0.8,0.7,,2.2,40900,59900,146600,,1452545000,461425000,991120000,
23617.4,-27000,-646190000,1986735000,2632925000,4619660000,566029347.8,1370177173.9,1.2,57419.6,167.4,0,1900,-40000,-966555000,24150,"2023-03-17T09:25:00.000Z",1679045100000,24200,24150,24200,4.3,95.7,0,0.1,0.7,,22.1,41900,43800,190400,,1058515000,45980000,1012535000,
23617.4,-47900,-1150520000,2366070000,3516590000,5882660000,566029347.8,1370177173.9,0.6,57419.6,167.4,0.4,15700,-20900,-504330000,24200,"2023-03-17T09:30:00.000Z",1679045400000,24200,24100,24150,30,70,0,0.7,0.6,,2.3,36600,52300,242700,,1263000000,379335000,883665000,
23617.4,1400,44145000,4176640000,4132495000,8309135000,566029347.8,1370177173.9,-1.5,57419.6,167.4,2.9,74700,49300,1194665000,24250,"2023-03-17T09:35:00.000Z",1679045700000,24300,24200,24200,74.6,25.4,0,3.2,0.4,,0.3,25400,100100,342800,,2426475000,1810570000,615905000,
23617.4,7700,197270000,4564990000,4367720000,8932710000,566029347.8,1370177173.9,-0.2,57419.6,167.4,1.6,16000,6300,153125000,24300,"2023-03-17T09:40:00.000Z",1679046000000,24300,24250,24250,62.3,37.7,0,0.7,0.2,,0.6,9700,25700,368500,,623575000,388350000,235225000,
23617.4,-32700,-780600000,4896990000,5677590000,10574580000,566029347.8,1370177173.9,1.2,57419.6,167.4,0.3,13700,-40400,-977870000,24200,"2023-03-17T09:45:00.000Z",1679046300000,24300,24200,24300,20.2,79.8,0,0.6,0.9,,3.9,54100,67800,436300,,1641870000,332000000,1309870000,
23617.4,-30700,-731225000,5417290000,6148515000,11565805000,566029347.8,1370177173.9,-0.1,57419.6,167.4,1.1,21500,2000,49375000,24200,"2023-03-17T09:50:00.000Z",1679046600000,24200,24150,24200,52.4,47.6,0,0.9,0.3,,0.9,19500,41000,477300,,991225000,520300000,470925000,
23617.4,-18400,-433465000,5763350000,6196815000,11960165000,566029347.8,1370177173.9,-0.4,57419.6,167.4,7.2,14300,12300,297760000,24150,"2023-03-17T09:55:00.000Z",1679046900000,24200,24150,24200,87.7,12.3,0,0.6,0,,0.1,2000,16300,493600,,394360000,346060000,48300000,
23617.4,-35200,-838995000,5855310000,6694305000,12549615000,566029347.8,1370177173.9,0.5,57419.6,167.4,0.2,3800,-16800,-405530000,24200,"2023-03-17T10:00:00.000Z",1679047200000,24200,24150,24150,15.6,84.4,0,0.2,0.4,,5.4,20600,24400,518000,,589450000,91960000,497490000,
23617.4,-56200,-1345675000,5879490000,7225165000,13104655000,566029347.8,1370177173.9,0.6,57419.6,167.4,0,1000,-21000,-506680000,24100,"2023-03-17T10:05:00.000Z",1679047500000,24200,24100,24200,4.3,95.7,0,0,0.4,,22,22000,23000,541000,,555040000,24180000,530860000,
23617.4,-108100,-2594620000,5994930000,8589550000,14584480000,566029347.8,1370177173.9,1.6,57419.6,167.4,0.1,4800,-51900,-1248945000,24050,"2023-03-17T10:10:00.000Z",1679047800000,24100,24000,24100,7.8,92.2,0,0.2,1,,11.8,56700,61500,602500,,1479825000,115440000,1364385000,
23617.4,-106500,-2555825000,6233125000,8788950000,15022075000,566029347.8,1370177173.9,0,57419.6,167.4,1.2,9900,1600,38795000,24100,"2023-03-17T10:15:00.000Z",1679048100000,24100,24000,24050,54.4,45.6,0,0.4,0.1,,0.8,8300,18200,620700,,437595000,238195000,199400000,
23617.4,-110400,-2649460000,6310245000,8959705000,15269950000,566029347.8,1370177173.9,0.1,57419.6,167.4,0.5,3200,-3900,-93635000,24100,"2023-03-17T10:20:00.000Z",1679048400000,24100,24050,24100,31.1,68.9,0,0.1,0.1,,2.2,7100,10300,631000,,247875000,77120000,170755000,
23617.4,-102700,-2461880000,7411765000,9873645000,17285410000,566029347.8,1370177173.9,-0.2,57419.6,167.4,1.2,45700,7700,187580000,24150,"2023-03-17T10:25:00.000Z",1679048700000,24150,24050,24100,54.6,45.4,0,1.9,0.7,,0.8,38000,83700,714700,,2015460000,1101520000,913940000,
23617.4,-77700,-1857650000,8076345000,9933995000,18010340000,566029347.8,1370177173.9,-0.8,57419.6,167.4,11,27500,25000,604230000,24200,"2023-03-17T10:30:00.000Z",1679049000000,24200,24100,24150,91.7,8.3,0,1.2,0,,0.1,2500,30000,744700,,724930000,664580000,60350000,
23617.4,-80500,-1925105000,8107740000,10032845000,18140585000,566029347.8,1370177173.9,0.1,57419.6,167.4,0.3,1300,-2800,-67455000,24150,"2023-03-17T10:35:00.000Z",1679049300000,24150,24100,24150,24.1,75.9,0,0.1,0.1,,3.2,4100,5400,750100,,130245000,31395000,98850000,
23617.4,-70900,-1693260000,8341995000,10035255000,18377250000,566029347.8,1370177173.9,-0.3,57419.6,167.4,97,9700,9600,231845000,24150,"2023-03-17T10:40:00.000Z",1679049600000,24150,24100,24150,99,1,0,0.4,0,,0,100,9800,759900,,236665000,234255000,2410000,
23617.4,-97000,-2322115000,8346815000,10668930000,19015745000,566029347.8,1370177173.9,0.8,57419.6,167.4,0,200,-26100,-628855000,24050,"2023-03-17T10:45:00.000Z",1679049900000,24100,24050,24100,0.8,99.2,0,0,0.5,,131.5,26300,26500,786400,,638495000,4820000,633675000,
23617.4,-175400,-4204380000,8375645000,12580025000,20955670000,566029347.8,1370177173.9,2.3,57419.6,167.4,0,1200,-78400,-1882265000,24000,"2023-03-17T10:50:00.000Z",1679050200000,24050,24000,24050,1.5,98.5,0,0.1,1.4,,66.3,79600,80800,867200,,1939925000,28830000,1911095000,
23617.4,-162400,-3891565000,9110045000,13001610000,22111655000,566029347.8,1370177173.9,-0.4,57419.6,167.4,1.7,30600,13000,312815000,24000,"2023-03-17T10:55:00.000Z",1679050500000,24000,23950,24000,63.5,36.5,0,1.3,0.3,,0.6,17600,48200,915400,,1155985000,734400000,421585000,
23617.4,-156500,-3748960000,9734045000,13483005000,23217050000,566029347.8,1370177173.9,-0.2,57419.6,167.4,1.3,26000,5900,142605000,23950,"2023-03-17T11:00:00.000Z",1679050800000,24000,23950,24000,56.4,43.6,0,1.1,0.4,,0.8,20100,46100,961500,,1105395000,624000000,481395000,
23617.4,-215300,-5157010000,9868230000,15025240000,24893470000,566029347.8,1370177173.9,1.8,57419.6,167.4,0.1,5600,-58800,-1408050000,23950,"2023-03-17T11:05:00.000Z",1679051100000,24000,23900,24000,8,92,0,0.2,1.1,,11.5,64400,70000,1031500,,1676420000,134185000,1542235000,
23617.4,-242600,-5810555000,9961635000,15772190000,25733825000,566029347.8,1370177173.9,0.8,57419.6,167.4,0.1,3900,-27300,-653545000,23900,"2023-03-17T11:10:00.000Z",1679051400000,23950,23900,23950,11.1,88.9,0,0.2,0.5,,8,31200,35100,1066600,,840355000,93405000,746950000,
23617.4,-318600,-7626935000,10078760000,17705695000,27784455000,566029347.8,1370177173.9,2.3,57419.6,167.4,0.1,4900,-76000,-1816380000,23900,"2023-03-17T11:15:00.000Z",1679051700000,23950,23850,23900,5.7,94.3,0,0.2,1.4,,16.5,80900,85800,1152400,,2050630000,117125000,1933505000,
23617.4,-337000,-8066505000,10191280000,18257785000,28449065000,566029347.8,1370177173.9,0.5,57419.6,167.4,0.2,4700,-18400,-439570000,23900,"2023-03-17T11:20:00.000Z",1679052000000,23950,23900,23900,16.9,83.1,0,0.2,0.4,,4.9,23100,27800,1180200,,664610000,112520000,552090000,
23617.4,-340900,-8159305000,10387670000,18546975000,28934645000,566029347.8,1370177173.9,0.1,57419.6,167.4,0.7,8200,-3900,-92800000,23950,"2023-03-17T11:25:00.000Z",1679052300000,23950,23900,23950,40.4,59.6,0,0.3,0.2,,1.5,12100,20300,1200500,,485580000,196390000,289190000,
23617.4,-396800,-9494140000,11869675000,21363815000,33238270000,566029347.8,1370177173.9,1.7,57419.6,167.4,0.5,62100,-55900,-1334835000,23900,"2023-03-17T13:00:00.000Z",1679058000000,23900,23800,23900,34.4,65.4,0.1,2.6,2.1,1.2,1.9,118000,180300,1380800,200,4303625000,1482005000,2816840000,4780000
23617.4,-353700,-8462445000,14080520000,22542965000,36673580000,566029347.8,1370177173.9,-1.3,57419.6,167.4,1.9,92500,43100,1031695000,23900,"2023-03-17T13:05:00.000Z",1679058300000,23950,23850,23850,64.3,34.4,1.3,3.9,0.9,11.4,0.5,49400,143800,1524600,1900,3435310000,2210845000,1179150000,45315000
23617.4,-551500,-13173870000,14546180000,27720050000,42316325000,566029347.8,1370177173.9,5.9,57419.6,167.4,0.1,19500,-197800,-4711425000,23800,"2023-03-17T13:10:00.000Z",1679058600000,23950,23800,23950,8.2,91.8,0,0.8,3.8,,11.1,217300,236800,1761400,,5642745000,465660000,5177085000,
23617.4,-591900,-14132795000,15633335000,29766130000,45449560000,566029347.8,1370177173.9,1.2,57419.6,167.4,0.5,45700,-40400,-958925000,23800,"2023-03-17T13:15:00.000Z",1679058900000,23800,23750,23800,34.7,65.3,0,1.9,1.5,,1.9,86100,131800,1893200,,3133235000,1087155000,2046080000,
23617.4,-597600,-14268320000,15771375000,30039695000,45861165000,566029347.8,1370177173.9,0.2,57419.6,167.4,0.5,5800,-5700,-135525000,23800,"2023-03-17T13:20:00.000Z",1679059200000,23800,23750,23800,33.5,66.5,0,0.2,0.2,,2,11500,17300,1910500,,411605000,138040000,273565000,
23617.4,-740800,-17666370000,16231600000,33897970000,50179665000,566029347.8,1370177173.9,4.2,57419.6,167.4,0.1,19400,-143200,-3398050000,23700,"2023-03-17T13:25:00.000Z",1679059500000,23850,23650,23800,10.7,89.3,0,0.8,2.8,,8.4,162600,182000,2092500,,4318500000,460225000,3858275000,
23617.4,-734600,-17518200000,17040865000,34559065000,51650025000,566029347.8,1370177173.9,-0.2,57419.6,167.4,1.2,34100,6200,148170000,23750,"2023-03-17T13:30:00.000Z",1679059800000,23750,23650,23700,55,45,0,1.4,0.5,,0.8,27900,62000,2154500,,1470360000,809265000,661095000,
23617.4,-725200,-17292125000,18255295000,35547420000,53886200000,566029347.8,1370177173.9,-0.3,57419.6,167.4,1.2,51000,9400,226075000,23850,"2023-03-17T13:35:00.000Z",1679060100000,23850,23750,23800,54.3,44.3,1.5,2.2,0.7,8.4,0.8,41600,94000,2248500,1400,2236175000,1214430000,988355000,33390000
23617.4,-726400,-17320340000,19556415000,36876755000,56516655000,566029347.8,1370177173.9,0,57419.6,167.4,1,54600,-1200,-28215000,23850,"2023-03-17T13:40:00.000Z",1679060400000,23900,23750,23850,49.5,50.5,0,2.3,1,,1,55800,110400,2358900,,2630455000,1301120000,1329335000,
23617.4,-841800,-20069655000,19847570000,39917225000,59848280000,566029347.8,1370177173.9,3.4,57419.6,167.4,0.1,12200,-115400,-2749315000,23850,"2023-03-17T13:45:00.000Z",1679060700000,23900,23800,23850,8.7,91.3,0,0.5,2.2,,10.5,127600,139800,2498700,,3331625000,291155000,3040470000,
23617.4,-872500,-20796230000,21014610000,41810840000,62908935000,566029347.8,1370177173.9,0.9,57419.6,167.4,0.6,48900,-30700,-726575000,23750,"2023-03-17T13:50:00.000Z",1679061000000,23900,23750,23850,38.1,61.9,0,2.1,1.4,,1.6,79600,128500,2627200,,3060655000,1167040000,1893615000,
23617.4,-895700,-21349850000,21626900000,42976750000,64687135000,566029347.8,1370177173.9,0.7,57419.6,167.4,0.5,25600,-23200,-553620000,23850,"2023-03-17T13:55:00.000Z",1679061300000,23950,23850,23900,34.4,65.6,0,1.1,0.8,,1.9,48800,74400,2701600,,1778200000,612290000,1165910000,
23617.4,-876100,-20880365000,22416525000,43296890000,65808875000,566029347.8,1370177173.9,-0.6,57419.6,167.4,2.5,33000,19600,469485000,23950,"2023-03-17T14:00:00.000Z",1679061600000,23950,23850,23900,70.4,28.6,1.1,1.4,0.2,3,0.4,13400,46900,2748500,500,1121740000,789625000,320140000,11975000
23617.4,-916500,-21844005000,22910405000,44754410000,67760275000,566029347.8,1370177173.9,1.2,57419.6,167.4,0.3,20700,-40400,-963640000,23850,"2023-03-17T14:05:00.000Z",1679061900000,23950,23800,23950,25.3,74.7,0,0.9,1.1,,3,61100,81800,2830300,,1951400000,493880000,1457520000,
23617.4,-927300,-22100855000,23424255000,45525110000,69044825000,566029347.8,1370177173.9,0.3,57419.6,167.4,0.7,21500,-10800,-256850000,23850,"2023-03-17T14:10:00.000Z",1679062200000,23900,23850,23850,40,60,0,0.9,0.6,,1.5,32300,53800,2884100,,1284550000,513850000,770700000,
23617.4,-1262600,-30049315000,23888605000,53937920000,78009490000,566029347.8,1370177173.9,9.9,57419.6,167.4,0.1,19500,-335300,-7948460000,23600,"2023-03-17T14:15:00.000Z",1679062500000,23900,23600,23900,5.2,93.9,1,0.8,6.2,22.1,18.2,354800,378000,3262100,3700,8964665000,464350000,8412810000,87505000
23617.4,-1235700,-29411400000,25248270000,54659670000,80090905000,566029347.8,1370177173.9,-0.8,57419.6,167.4,1.9,57300,26900,637915000,23750,"2023-03-17T14:20:00.000Z",1679062800000,23800,23650,23650,65.3,34.7,0,2.4,0.5,,0.5,30400,87700,3349800,,2081415000,1359665000,721750000,
23617.4,-1269400,-30210175000,26037350000,56247525000,82467840000,566029347.8,1370177173.9,1,57419.6,167.4,0.5,33200,-33700,-798775000,23750,"2023-03-17T14:25:00.000Z",1679063100000,23800,23700,23750,33.2,66.8,0,1.4,1.2,,2,66900,100100,3449900,,2376935000,789080000,1587855000,
23617.4,-1554900,-36990800000,26037350000,63028150000,89248465000,566029347.8,1370177173.9,8.4,57419.6,167.4,0,,-285500,-6780625000,23750,"2023-03-17T14:45:00.000Z",1679064300000,23750,23750,23750,0,100,0,,5,,Infinity,285500,285500,3735400,,6780625000,,6780625000,
