"abu","acum_busd","acum_busd_val","acum_val_bu","acum_val_sd","acum_val","avg_val_bu","avg_val_sd","rbusd","asd","auk","bs","bu","bu-sd","bu-sd_val","c","date","datetime","h","l","o","pbu","psd","puk","rbu","rsd","ruk","sb","sd","sum_vol","total_vol","uk","val","val_bu","val_sd","val_uk"
239657.4,286300,4503940000,7068680000,2564740000,9633420000,3797619148.9,4147264468.1,-12.9,263576.6,29312.8,2.8,448900,286300,4503940000,15800,"2023-03-03T09:15:00.000Z",1677834900000,15850,15650,15700,73.4,26.6,0,1.9,0.6,,0.4,162600,611500,611500,,9633420000,7068680000,2564740000,
239657.4,216800,3411940000,8487525000,5075585000,13563110000,3797619148.9,4147264468.1,3.1,263576.6,29312.8,0.6,90000,-69500,-1092000000,15700,"2023-03-03T09:20:00.000Z",1677835200000,15800,15700,15750,36.1,63.9,0,0.4,0.6,,1.8,159500,249500,861000,,3929690000,1418845000,2510845000,
239657.4,493600,7781515000,16390760000,8609245000,25000005000,3797619148.9,4147264468.1,-12.5,263576.6,29312.8,2.2,500900,276800,4369575000,15800,"2023-03-03T09:25:00.000Z",1677835500000,15850,15700,15700,69.1,30.9,0,2.1,0.9,,0.4,224100,725000,1586000,,11436895000,7903235000,3533660000,
239657.4,1908600,30394650000,40849630000,10454980000,51304610000,3797619148.9,4147264468.1,-64.7,263576.6,29312.8,13.2,1530800,1415000,22613135000,16150,"2023-03-03T09:30:00.000Z",1677835800000,16150,15800,15800,93,7,0,6.4,0.4,,0.1,115800,1646600,3232600,,26304605000,24458870000,1845735000,
239657.4,1645300,26201430000,45527240000,19325810000,64853050000,3797619148.9,4147264468.1,12,263576.6,29312.8,0.5,290500,-263300,-4193220000,15950,"2023-03-03T09:35:00.000Z",1677836100000,16150,15900,16150,34.4,65.6,0,1.2,2.1,,1.9,553800,844300,4076900,,13548440000,4677610000,8870830000,
239657.4,1613800,25701520000,48358135000,22656615000,71014750000,3797619148.9,4147264468.1,1.4,263576.6,29312.8,0.8,178000,-31500,-499910000,15900,"2023-03-03T09:40:00.000Z",1677836400000,15950,15850,15950,45.9,54.1,0,0.7,0.8,,1.2,209500,387500,4464400,,6161700000,2830895000,3330805000,
239657.4,1234200,19687165000,50072350000,30385185000,80457535000,3797619148.9,4147264468.1,17.2,263576.6,29312.8,0.2,108100,-379600,-6014355000,15850,"2023-03-03T09:45:00.000Z",1677836700000,15900,15800,15900,18.1,81.9,0,0.5,1.9,,4.5,487700,595800,5060200,,9442785000,1714215000,7728570000,
239657.4,1259700,20101055000,53627700000,33526645000,87154345000,3797619148.9,4147264468.1,-1.2,263576.6,29312.8,1.1,224300,25500,413890000,15850,"2023-03-03T09:50:00.000Z",1677837000000,15900,15800,15850,53,47,0,0.9,0.8,,0.9,198800,423100,5483300,,6696810000,3555350000,3141460000,
239657.4,1631000,26013035000,61283765000,35270730000,96554495000,3797619148.9,4147264468.1,-16.9,263576.6,29312.8,4.4,481000,371300,5911980000,15950,"2023-03-03T09:55:00.000Z",1677837300000,15950,15850,15900,81.4,18.6,0,2,0.4,,0.2,109700,590700,6074000,,9400150000,7656065000,1744085000,
239657.4,1405100,22430170000,62445035000,40014865000,102459900000,3797619148.9,4147264468.1,10.2,263576.6,29312.8,0.2,73000,-225900,-3582865000,15900,"2023-03-03T10:00:00.000Z",1677837600000,15950,15850,15950,19.6,80.4,0,0.3,1.1,,4.1,298900,371900,6445900,,5905405000,1161270000,4744135000,
239657.4,1453300,23195335000,64341670000,41146335000,105488005000,3797619148.9,4147264468.1,-2.2,263576.6,29312.8,1.7,119600,48200,765165000,15900,"2023-03-03T10:05:00.000Z",1677837900000,15900,15800,15900,62.6,37.4,0,0.5,0.3,,0.6,71400,191000,6636900,,3028105000,1896635000,1131470000,
239657.4,1483300,23673130000,65071480000,41398350000,106469830000,3797619148.9,4147264468.1,-1.4,263576.6,29312.8,2.9,45900,30000,477795000,15850,"2023-03-03T10:10:00.000Z",1677838200000,15900,15850,15900,74.3,25.7,0,0.2,0.1,,0.3,15900,61800,6698700,,981825000,729810000,252015000,
239657.4,1399400,22345655000,66254640000,43908985000,110163625000,3797619148.9,4147264468.1,3.8,263576.6,29312.8,0.5,74500,-83900,-1327475000,15850,"2023-03-03T10:15:00.000Z",1677838500000,15900,15800,15900,32,68,0,0.3,0.6,,2.1,158400,232900,6931600,,3693795000,1183160000,2510635000,
239657.4,1441600,23015125000,67113710000,44098585000,111212295000,3797619148.9,4147264468.1,-1.9,263576.6,29312.8,4.5,54200,42200,669470000,15850,"2023-03-03T10:20:00.000Z",1677838800000,15850,15800,15850,81.9,18.1,0,0.2,0,,0.2,12000,66200,6997800,,1048670000,859070000,189600000,
239657.4,1456400,23250725000,67671630000,44420905000,112092535000,3797619148.9,4147264468.1,-0.7,263576.6,29312.8,1.7,35200,14800,235600000,15850,"2023-03-03T10:25:00.000Z",1677839100000,15850,15800,15850,63.3,36.7,0,0.1,0.1,,0.6,20400,55600,7053400,,880240000,557920000,322320000,
239657.4,1157500,18528925000,68103790000,49574865000,117678655000,3797619148.9,4147264468.1,13.5,263576.6,29312.8,0.1,27300,-298900,-4721800000,15800,"2023-03-03T10:30:00.000Z",1677839400000,15850,15800,15850,7.7,92.3,0,0.1,1.2,,11.9,326200,353500,7406900,,5586120000,432160000,5153960000,
239657.4,1293700,20685080000,70935875000,50250795000,121186670000,3797619148.9,4147264468.1,-6.2,263576.6,29312.8,4.2,179000,136200,2156155000,15800,"2023-03-03T10:35:00.000Z",1677839700000,15850,15750,15800,80.7,19.3,0,0.7,0.2,,0.2,42800,221800,7628700,,3508015000,2832085000,675930000,
239657.4,1188900,19030680000,71392355000,52361675000,123754030000,3797619148.9,4147264468.1,4.7,263576.6,29312.8,0.2,28800,-104800,-1654400000,15850,"2023-03-03T10:40:00.000Z",1677840000000,15850,15800,15800,17.7,82.3,0,0.1,0.5,,4.6,133600,162400,7791100,,2567360000,456480000,2110880000,
239657.4,947500,15225710000,72672625000,57446915000,130119540000,3797619148.9,4147264468.1,10.9,263576.6,29312.8,0.3,81000,-241400,-3804970000,15750,"2023-03-03T10:45:00.000Z",1677840300000,15850,15750,15850,20.1,79.9,0,0.3,1.2,,4,322400,403400,8194500,,6365510000,1280270000,5085240000,
239657.4,991300,15918160000,74261800000,58343640000,132605440000,3797619148.9,4147264468.1,-2,263576.6,29312.8,1.8,100900,43800,692450000,15750,"2023-03-03T10:50:00.000Z",1677840600000,15750,15700,15750,63.9,36.1,0,0.4,0.2,,0.6,57100,158000,8352500,,2485900000,1589175000,896725000,
239657.4,887300,14286635000,76337825000,62051190000,138389015000,3797619148.9,4147264468.1,4.7,263576.6,29312.8,0.6,131400,-104000,-1631525000,15750,"2023-03-03T10:55:00.000Z",1677840900000,15800,15750,15750,35.8,64.2,0,0.5,0.9,,1.8,235400,366800,8719300,,5783575000,2076025000,3707550000,
239657.4,1045600,16782000000,79571355000,62789355000,142360710000,3797619148.9,4147264468.1,-7.1,263576.6,29312.8,4.4,205300,158300,2495365000,15750,"2023-03-03T11:00:00.000Z",1677841200000,15800,15700,15750,81.4,18.6,0,0.9,0.2,,0.2,47000,252300,8971600,,3971695000,3233530000,738165000,
239657.4,1115700,17887230000,81268755000,63381525000,144650280000,3797619148.9,4147264468.1,-3.2,263576.6,29312.8,2.9,107700,70100,1105230000,15800,"2023-03-03T11:05:00.000Z",1677841500000,15800,15700,15750,74.1,25.9,0,0.4,0.1,,0.3,37600,145300,9116900,,2289570000,1697400000,592170000,
239657.4,1239400,19842525000,83325160000,63482635000,146807795000,3797619148.9,4147264468.1,-5.6,263576.6,29312.8,20.3,130100,123700,1955295000,15850,"2023-03-03T11:10:00.000Z",1677841800000,15850,15750,15800,95.3,4.7,0,0.5,0,,0,6400,136500,9253400,,2157515000,2056405000,101110000,
239657.4,1075600,17260625000,83686440000,66425815000,150112255000,3797619148.9,4147264468.1,7.4,263576.6,29312.8,0.1,22800,-163800,-2581900000,15750,"2023-03-03T11:15:00.000Z",1677842100000,15850,15750,15850,10.9,89.1,0,0.1,0.7,,8.2,186600,209400,9462800,,3304460000,361280000,2943180000,
239657.4,948300,15255800000,83744865000,68489065000,152233930000,3797619148.9,4147264468.1,5.7,263576.6,29312.8,0,3700,-127300,-2004825000,15750,"2023-03-03T11:20:00.000Z",1677842400000,15800,15750,15750,2.7,97.3,0,0,0.5,,35.4,131000,134700,9597500,,2121675000,58425000,2063250000,
239657.4,938800,15106735000,84361125000,69254390000,153615515000,3797619148.9,4147264468.1,0.4,263576.6,29312.8,0.8,39100,-9500,-149065000,15750,"2023-03-03T11:25:00.000Z",1677842700000,15800,15700,15800,44.6,55.4,0,0.2,0.2,,1.2,48600,87700,9685200,,1381585000,616260000,765325000,
239657.4,620100,10146590000,91580960000,81434370000,173015330000,3797619148.9,4147264468.1,14.2,263576.6,29312.8,0.6,460000,-318700,-4960145000,15700,"2023-03-03T13:00:00.000Z",1677848400000,15750,15550,15700,37.1,62.9,0,1.9,3,,1.7,778700,1238700,10923900,,19399815000,7219835000,12179980000,
239657.4,679400,11085375000,96255680000,85170305000,181425985000,3797619148.9,4147264468.1,-2.7,263576.6,29312.8,1.2,296600,59300,938785000,15700,"2023-03-03T13:05:00.000Z",1677848700000,15800,15700,15700,55.6,44.4,0,1.2,0.9,,0.8,237300,533900,11457800,,8410655000,4674720000,3735935000,
239657.4,780600,12686895000,99746190000,87059295000,186805485000,3797619148.9,4147264468.1,-4.6,263576.6,29312.8,1.8,221100,101200,1601520000,15800,"2023-03-03T13:10:00.000Z",1677849000000,15850,15700,15750,64.8,35.2,0,0.9,0.5,,0.5,119900,341000,11798800,,5379500000,3490510000,1888990000,
239657.4,1003000,16201320000,104562395000,88361075000,192923470000,3797619148.9,4147264468.1,-10.1,263576.6,29312.8,3.7,304800,222400,3514425000,15800,"2023-03-03T13:15:00.000Z",1677849300000,15850,15750,15800,78.7,21.3,0,1.3,0.3,,0.3,82400,387200,12186000,,6117985000,4816205000,1301780000,
239657.4,1512600,24302165000,113520725000,89218560000,202739285000,3797619148.9,4147264468.1,-23.2,263576.6,29312.8,10.4,563700,509600,8100845000,15950,"2023-03-03T13:20:00.000Z",1677849600000,15950,15800,15800,91.2,8.8,0,2.4,0.2,,0.1,54100,617800,12803800,,9815815000,8958330000,857485000,
239657.4,2329200,37369005000,131263735000,93894730000,225158465000,3797619148.9,4147264468.1,-37.4,263576.6,29312.8,3.8,1109400,816600,13066840000,15950,"2023-03-03T13:25:00.000Z",1677849900000,16050,15950,15950,79.1,20.9,0,4.6,1.1,,0.3,292800,1402200,14206000,,22419180000,17743010000,4676170000,
239657.4,2344000,37607260000,133622550000,96015290000,229637840000,3797619148.9,4147264468.1,-0.7,263576.6,29312.8,1.1,148200,14800,238255000,15900,"2023-03-03T13:30:00.000Z",1677850200000,15950,15850,15900,52.6,47.4,0,0.6,0.5,,0.9,133400,281600,14487600,,4479375000,2358815000,2120560000,
239657.4,2317500,37187700000,136269580000,99081880000,235351460000,3797619148.9,4147264468.1,1.2,263576.6,29312.8,0.9,166400,-26500,-419560000,15900,"2023-03-03T13:35:00.000Z",1677850500000,15950,15850,15900,46.3,53.7,0,0.7,0.7,,1.2,192900,359300,14846900,,5713620000,2647030000,3066590000,
239657.4,2383700,38240520000,139761455000,101520935000,241282390000,3797619148.9,4147264468.1,-3,263576.6,29312.8,1.4,219600,66200,1052820000,15900,"2023-03-03T13:40:00.000Z",1677850800000,15950,15850,15900,58.9,41.1,0,0.9,0.6,,0.7,153400,373000,15219900,,5930930000,3491875000,2439055000,
239657.4,1907500,30710500000,141465590000,110755090000,252220680000,3797619148.9,4147264468.1,21.5,263576.6,29312.8,0.2,107500,-476200,-7530020000,15750,"2023-03-03T13:45:00.000Z",1677851100000,15900,15750,15900,15.6,84.4,0,0.4,2.2,,5.4,583700,691200,15911100,,10938290000,1704135000,9234155000,
239657.4,1712900,27647565000,143757625000,116110060000,259867685000,3797619148.9,4147264468.1,8.8,263576.6,29312.8,0.4,145400,-194600,-3062935000,15800,"2023-03-03T13:50:00.000Z",1677851400000,15800,15700,15750,30,70,0,0.6,1.3,,2.3,340000,485400,16396500,,7647005000,2292035000,5354970000,
239657.4,1922000,30967835000,149357280000,118389445000,267746725000,3797619148.9,4147264468.1,-9.5,263576.6,29312.8,2.4,353800,209100,3320270000,15900,"2023-03-03T13:55:00.000Z",1677851700000,15900,15750,15800,71,29,0,1.5,0.5,,0.4,144700,498500,16895000,,7879040000,5599655000,2279385000,
239657.4,2098800,33782190000,155317455000,121535265000,276852720000,3797619148.9,4147264468.1,-8,263576.6,29312.8,1.9,374700,176800,2814355000,15850,"2023-03-03T14:00:00.000Z",1677852000000,15950,15850,15900,65.4,34.6,0,1.6,0.8,,0.5,197900,572600,17467600,,9105995000,5960175000,3145820000,
239657.4,1567200,25383785000,157721260000,132337475000,290058735000,3797619148.9,4147264468.1,24,263576.6,29312.8,0.2,152200,-531600,-8398405000,15750,"2023-03-03T14:05:00.000Z",1677852300000,15850,15700,15850,18.2,81.8,0,0.6,2.6,,4.5,683800,836000,18303600,,13206015000,2403805000,10802210000,
239657.4,248800,4847780000,161063535000,156215755000,317287115000,3797619148.9,4147264468.1,58.7,263576.6,29312.8,0.1,212600,-1318400,-20536005000,15650,"2023-03-03T14:10:00.000Z",1677852600000,15800,15500,15750,12.2,87.8,0,0.9,5.8,0,7.2,1531000,1744100,20047700,500,27228380000,3342275000,23878280000,7825000
239657.4,118200,2830610000,168617475000,165786865000,334412165000,3797619148.9,4147264468.1,5.8,263576.6,29312.8,0.8,482500,-130600,-2017170000,15700,"2023-03-03T14:15:00.000Z",1677852900000,15750,15550,15600,44,56,0,2,2.3,,1.3,613100,1095600,21143300,,17125050000,7553940000,9571110000,
239657.4,110600,2722295000,172581585000,169859290000,342448700000,3797619148.9,4147264468.1,0.3,263576.6,29312.8,1,252900,-7600,-108315000,15700,"2023-03-03T14:20:00.000Z",1677853200000,15700,15600,15700,49.3,50.7,0,1.1,1,,1,260500,513400,21656700,,8036535000,3964110000,4072425000,
239657.4,-1123300,-16419475000,178486555000,194906030000,373450220000,3797619148.9,4147264468.1,54.7,263576.6,29312.8,0.2,380400,-1233900,-19141770000,15400,"2023-03-03T14:25:00.000Z",1677853500000,15700,15400,15650,19,80.8,0.2,1.6,6.1,0.1,4.2,1614300,1997900,23654600,3200,31001520000,5904970000,25046740000,49810000
239657.4,-1124200,-16433330000,178488100000,194921430000,373467165000,3797619148.9,4147264468.1,0,263576.6,29312.8,0.1,100,-900,-13855000,15450,"2023-03-03T14:30:00.000Z",1677853800000,15450,15400,15400,9.1,90.9,0,0,0,,10,1000,1100,23655700,,16945000,1545000,15400000,
239657.4,-1124200,-16433330000,178488100000,194921430000,394489365000,3797619148.9,4147264468.1,0,263576.6,29312.8,NaN,,0,0,15300,"2023-03-03T14:45:00.000Z",1677854700000,15300,15300,15300,0,0,100,,,46.9,NaN,,1374000,25029700,1374000,21022200000,,,21022200000
