"abu","acum_busd","acum_busd_val","acum_val_bu","acum_val_sd","acum_val","avg_val_bu","avg_val_sd","rbusd","asd","auk","bs","bu","bu-sd","bu-sd_val","c","date","datetime","h","l","o","pbu","psd","puk","rbu","rsd","ruk","sb","sd","sum_vol","total_vol","uk","val","val_bu","val_sd","val_uk"
59593.5,-126700,-1686485000,169785000,1856270000,2026055000,789052065.2,1313729891.3,3.2,99626.1,206.5,0.1,12700,-126700,-1686485000,13250,"2023-02-13T09:15:00.000Z",1676279700000,13400,13200,13350,8.3,91.7,0,0.2,1.4,,11,139400,152100,152100,,2026055000,169785000,1856270000,
59593.5,-220500,-2928010000,779055000,3707065000,4486120000,789052065.2,1313729891.3,2.4,99626.1,206.5,0.3,45900,-93800,-1241525000,13300,"2023-02-13T09:20:00.000Z",1676280000000,13300,13200,13250,24.7,75.3,0,0.8,1.4,,3,139700,185600,337700,,2460065000,609270000,1850795000,
59593.5,-205100,-2721560000,1602835000,4324395000,5927230000,789052065.2,1313729891.3,-0.4,99626.1,206.5,1.3,61800,15400,206450000,13450,"2023-02-13T09:25:00.000Z",1676280300000,13450,13250,13300,57.1,42.9,0,1,0.5,,0.8,46400,108200,445900,,1441110000,823780000,617330000,
59593.5,-191100,-2532715000,2253980000,4786695000,7040675000,789052065.2,1313729891.3,-0.4,99626.1,206.5,1.4,48500,14000,188845000,13400,"2023-02-13T09:30:00.000Z",1676280600000,13450,13400,13400,58.4,41.6,0,0.8,0.3,,0.7,34500,83000,528900,,1113445000,651145000,462300000,
59593.5,-223500,-2965930000,2397045000,5362975000,7760020000,789052065.2,1313729891.3,0.8,99626.1,206.5,0.2,10700,-32400,-433215000,13350,"2023-02-13T09:35:00.000Z",1676280900000,13450,13300,13400,19.9,80.1,0,0.2,0.4,,4,43100,53800,582700,,719345000,143065000,576280000,
59593.5,-309800,-4109730000,2479280000,6589010000,9069615000,789052065.2,1313729891.3,2.2,99626.1,206.5,0.1,6200,-86300,-1143800000,13250,"2023-02-13T09:40:00.000Z",1676281200000,13350,13200,13300,6.3,93.6,0.1,0.1,0.9,0.5,14.9,92500,98800,681500,100,1309595000,82235000,1226035000,1325000
59593.5,-311200,-4127345000,2775690000,6903035000,9680050000,789052065.2,1313729891.3,0,99626.1,206.5,0.9,22300,-1400,-17615000,13300,"2023-02-13T09:45:00.000Z",1676281500000,13300,13250,13250,48.5,51.5,0,0.4,0.2,,1.1,23700,46000,727500,,610435000,296410000,314025000,
59593.5,-346400,-4591690000,3207920000,7799610000,11008855000,789052065.2,1313729891.3,0.9,99626.1,206.5,0.5,32600,-35200,-464345000,13250,"2023-02-13T09:50:00.000Z",1676281800000,13300,13200,13300,32.5,67.5,0,0.5,0.7,,2.1,67800,100400,827900,,1328805000,432230000,896575000,
59593.5,-469000,-6206825000,3413635000,9620460000,13035420000,789052065.2,1313729891.3,3.1,99626.1,206.5,0.1,15600,-122600,-1615135000,13150,"2023-02-13T09:55:00.000Z",1676282100000,13250,13150,13200,10.1,89.9,0,0.3,1.4,,8.9,138200,153800,981700,,2026565000,205715000,1820850000,
59593.5,-591500,-7809040000,3688440000,11497480000,15226545000,789052065.2,1313729891.3,3.1,99626.1,206.5,0.1,20900,-122500,-1602215000,13150,"2023-02-13T10:00:00.000Z",1676282400000,13150,13050,13150,12.5,85.7,1.8,0.4,1.4,14.5,6.9,143400,167300,1149000,3000,2191125000,274805000,1877020000,39300000
59593.5,-630700,-8322700000,3853985000,12176685000,16072610000,789052065.2,1313729891.3,1,99626.1,206.5,0.2,12600,-39200,-513660000,13100,"2023-02-13T10:05:00.000Z",1676282700000,13200,13100,13100,19.5,80.3,0.2,0.2,0.5,0.5,4.1,51800,64500,1213500,100,846065000,165545000,679205000,1315000
59593.5,-622600,-8215820000,5215305000,13431125000,18688370000,789052065.2,1313729891.3,-0.2,99626.1,206.5,1.1,103900,8100,106880000,13050,"2023-02-13T10:10:00.000Z",1676283000000,13200,13050,13100,52,48,0,1.7,1,,0.9,95800,199700,1413200,,2615760000,1361320000,1254440000,
59593.5,-1039100,-13623465000,6159365000,19782830000,25984135000,789052065.2,1313729891.3,10.3,99626.1,206.5,0.1,72700,-416500,-5407645000,13000,"2023-02-13T10:15:00.000Z",1676283300000,13050,12900,13050,12.9,87.1,0,1.2,4.9,,6.7,489200,561900,1975100,,7295765000,944060000,6351705000,
59593.5,-955900,-12539880000,7560415000,20100295000,27702650000,789052065.2,1313729891.3,-2.1,99626.1,206.5,4.4,107700,83200,1083585000,13050,"2023-02-13T10:20:00.000Z",1676283600000,13050,12950,12950,81.5,18.5,0,1.8,0.2,,0.2,24500,132200,2107300,,1718515000,1401050000,317465000,
59593.5,-961500,-12612230000,7762115000,20374345000,28178400000,789052065.2,1313729891.3,0.1,99626.1,206.5,0.7,15400,-5600,-72350000,13050,"2023-02-13T10:25:00.000Z",1676283900000,13100,13050,13050,42.3,57.7,0,0.3,0.2,,1.4,21000,36400,2143700,,475750000,201700000,274050000,
59593.5,-855800,-11226280000,9225540000,20451820000,29719300000,789052065.2,1313729891.3,-2.6,99626.1,206.5,18.9,111600,105700,1385950000,13150,"2023-02-13T10:30:00.000Z",1676284200000,13150,13050,13100,95,5,0,1.9,0.1,,0.1,5900,117500,2261200,,1540900000,1463425000,77475000,
59593.5,-860300,-11284645000,9439380000,20724025000,30205345000,789052065.2,1313729891.3,0.1,99626.1,206.5,0.8,16200,-4500,-58365000,13200,"2023-02-13T10:35:00.000Z",1676284500000,13200,13150,13150,43.9,56.1,0,0.3,0.2,,1.3,20700,36900,2298100,,486045000,213840000,272205000,
59593.5,-856200,-11229845000,9673020000,20902865000,30617825000,789052065.2,1313729891.3,-0.1,99626.1,206.5,1.3,17700,4100,54800000,13150,"2023-02-13T10:40:00.000Z",1676284800000,13200,13150,13200,56.5,43.5,0,0.3,0.1,,0.8,13600,31300,2329400,,412480000,233640000,178840000,
59593.5,-833100,-10924250000,10254375000,21178625000,31474940000,789052065.2,1313729891.3,-0.6,99626.1,206.5,2.1,44000,23100,305595000,13200,"2023-02-13T10:45:00.000Z",1676285100000,13250,13150,13200,67.8,32.2,0,0.7,0.2,,0.5,20900,64900,2394300,,857115000,581355000,275760000,
59593.5,-991300,-13012110000,10453900000,23466010000,33961850000,789052065.2,1313729891.3,4,99626.1,206.5,0.1,15100,-158200,-2087860000,13150,"2023-02-13T10:50:00.000Z",1676285400000,13250,13150,13250,8,92,0,0.3,1.7,,11.5,173300,188400,2582700,,2486910000,199525000,2287385000,
59593.5,-1016200,-13339430000,10532900000,23872330000,34447170000,789052065.2,1313729891.3,0.6,99626.1,206.5,0.2,6000,-24900,-327320000,13150,"2023-02-13T10:55:00.000Z",1676285700000,13200,13100,13150,16.3,83.7,0,0.1,0.3,,5.2,30900,36900,2619600,,485320000,79000000,406320000,
59593.5,-979400,-12855460000,11035255000,23890715000,34967910000,789052065.2,1313729891.3,-0.9,99626.1,206.5,27.3,38200,36800,483970000,13200,"2023-02-13T11:00:00.000Z",1676286000000,13200,13100,13150,96.5,3.5,0,0.6,0,,0,1400,39600,2659200,,520740000,502355000,18385000,
59593.5,-1024900,-13451840000,11055040000,24506880000,35603860000,789052065.2,1313729891.3,1.1,99626.1,206.5,0,1500,-45500,-596380000,13150,"2023-02-13T11:05:00.000Z",1676286300000,13200,13100,13150,3.1,96.9,0,0,0.5,,31.3,47000,48500,2707700,,635950000,19785000,616165000,
59593.5,-1091400,-14319930000,11256780000,25576710000,36875430000,789052065.2,1313729891.3,1.7,99626.1,206.5,0.2,15400,-66500,-868090000,13100,"2023-02-13T11:10:00.000Z",1676286600000,13100,13050,13100,15.8,84.2,0,0.3,0.8,,5.3,81900,97300,2805000,,1271570000,201740000,1069830000,
59593.5,-1090400,-14306500000,11594760000,25901260000,37537960000,789052065.2,1313729891.3,0,99626.1,206.5,1,25800,1000,13430000,13100,"2023-02-13T11:15:00.000Z",1676286900000,13100,13050,13100,51,49,0,0.4,0.2,,1,24800,50600,2855600,,662530000,337980000,324550000,
59593.5,-1098800,-14415975000,11632750000,26048725000,37723415000,789052065.2,1313729891.3,0.2,99626.1,206.5,0.3,2900,-8400,-109475000,13100,"2023-02-13T11:20:00.000Z",1676287200000,13100,13050,13100,20.4,79.6,0,0,0.1,,3.9,11300,14200,2869800,,185455000,37990000,147465000,
59593.5,-1106300,-14513515000,11720520000,26234035000,37996495000,789052065.2,1313729891.3,0.2,99626.1,206.5,0.5,6700,-7500,-97540000,13050,"2023-02-13T11:25:00.000Z",1676287500000,13100,13050,13100,32.1,67.9,0,0.1,0.1,,2.1,14200,20900,2890700,,273080000,87770000,185310000,
59593.5,-1144600,-15013285000,12168140000,27181425000,39391505000,789052065.2,1313729891.3,1,99626.1,206.5,0.5,34300,-38300,-499770000,13050,"2023-02-13T13:00:00.000Z",1676293200000,13100,13000,13050,32.1,67.9,0,0.6,0.7,,2.1,72600,106900,2997600,,1395010000,447620000,947390000,
59593.5,-1167700,-15315055000,13219635000,28534690000,41796265000,789052065.2,1313729891.3,0.6,99626.1,206.5,0.8,80200,-23100,-301770000,13150,"2023-02-13T13:05:00.000Z",1676293500000,13150,13100,13100,43.7,56.3,0,1.3,1,,1.3,103300,183500,3181100,,2404760000,1051495000,1353265000,
59593.5,-1208300,-15843255000,14434700000,30277955000,44754595000,789052065.2,1313729891.3,1,99626.1,206.5,0.7,92400,-40600,-528200000,13200,"2023-02-13T13:10:00.000Z",1676293800000,13200,13100,13150,41,59,0,1.6,1.3,,1.4,133000,225400,3406500,,2958330000,1215065000,1743265000,
59593.5,-1370800,-17980270000,16039960000,34020230000,50102130000,789052065.2,1313729891.3,4.1,99626.1,206.5,0.4,121700,-162500,-2137015000,13200,"2023-02-13T13:15:00.000Z",1676294100000,13250,13150,13150,30,70,0,2,2.9,,2.3,284200,405900,3812400,,5347535000,1605260000,3742275000,
59593.5,-1523700,-19992040000,16604950000,36596990000,53243880000,789052065.2,1313729891.3,3.8,99626.1,206.5,0.2,42700,-152900,-2011770000,13150,"2023-02-13T13:20:00.000Z",1676294400000,13250,13100,13100,17.9,82.1,0,0.7,2,,4.6,195600,238300,4050700,,3141750000,564990000,2576760000,
59593.5,-1727500,-22666945000,17288750000,39955695000,57286385000,789052065.2,1313729891.3,5.1,99626.1,206.5,0.2,52000,-203800,-2674905000,13100,"2023-02-13T13:25:00.000Z",1676294700000,13150,13100,13150,16.9,83.1,0,0.9,2.6,,4.9,255800,307800,4358500,,4042505000,683800000,3358705000,
59593.5,-1876700,-24615775000,19606030000,44221805000,63869775000,789052065.2,1313729891.3,3.7,99626.1,206.5,0.5,176700,-149200,-1948830000,13100,"2023-02-13T13:30:00.000Z",1676295000000,13150,13050,13100,35.2,64.8,0,3,3.3,,1.8,325900,502600,4861100,,6583390000,2317280000,4266110000,
59593.5,-1854300,-24320675000,20362245000,44682920000,65087105000,789052065.2,1313729891.3,-0.6,99626.1,206.5,1.6,57500,22400,295100000,13150,"2023-02-13T13:35:00.000Z",1676295300000,13200,13100,13150,62.1,37.9,0,1,0.4,,0.6,35100,92600,4953700,,1217330000,756215000,461115000,
59593.5,-1758000,-23048005000,21856120000,44904125000,66802185000,789052065.2,1313729891.3,-2.4,99626.1,206.5,6.7,113100,96300,1272670000,13250,"2023-02-13T13:40:00.000Z",1676295600000,13250,13150,13150,87.1,12.9,0,1.9,0.2,,0.1,16800,129900,5083600,,1715080000,1493875000,221205000,
59593.5,-1803500,-23648875000,22274120000,45922995000,68239055000,789052065.2,1313729891.3,1.1,99626.1,206.5,0.4,31500,-45500,-600870000,13200,"2023-02-13T13:45:00.000Z",1676295900000,13300,13200,13250,29,71,0,0.5,0.8,,2.4,77000,108500,5192100,,1436870000,418000000,1018870000,
59593.5,-1873700,-24574295000,22626595000,47200890000,69869425000,789052065.2,1313729891.3,1.8,99626.1,206.5,0.3,26700,-70200,-925420000,13150,"2023-02-13T13:50:00.000Z",1676296200000,13250,13150,13200,21.6,78.4,0,0.4,1,,3.6,96900,123600,5315700,,1630370000,352475000,1277895000,
59593.5,-1961600,-25730065000,22698925000,48428990000,71169855000,789052065.2,1313729891.3,2.2,99626.1,206.5,0.1,5500,-87900,-1155770000,13100,"2023-02-13T13:55:00.000Z",1676296500000,13200,13100,13150,5.6,94.4,0,0.1,0.9,,17,93400,98900,5414600,,1300430000,72330000,1228100000,
59593.5,-2015800,-26440595000,23215720000,49656315000,72913975000,789052065.2,1313729891.3,1.4,99626.1,206.5,0.4,39300,-54200,-710530000,13100,"2023-02-13T14:00:00.000Z",1676296800000,13150,13100,13100,29.6,70.4,0,0.7,0.9,,2.4,93500,132800,5547400,,1744120000,516795000,1227325000,
59593.5,-2015600,-26435465000,24574220000,51009685000,75625845000,789052065.2,1313729891.3,0,99626.1,206.5,1,103300,200,5130000,13150,"2023-02-13T14:05:00.000Z",1676297100000,13200,13100,13150,50,50,0,1.7,1,,1,103100,206400,5753800,,2711870000,1358500000,1353370000,
59593.5,-2050000,-26886395000,24951740000,51838135000,76831815000,789052065.2,1313729891.3,0.9,99626.1,206.5,0.5,28600,-34400,-450930000,13200,"2023-02-13T14:10:00.000Z",1676297400000,13200,13150,13150,31.2,68.8,0,0.5,0.6,,2.2,63000,91600,5845400,,1205970000,377520000,828450000,
59593.5,-1727900,-22618515000,29886625000,52505140000,82433705000,789052065.2,1313729891.3,-8.1,99626.1,206.5,7.4,372700,322100,4267880000,13450,"2023-02-13T14:15:00.000Z",1676297700000,13450,13150,13200,88,12,0,6.3,0.5,,0.1,50600,423300,6268700,,5601890000,4934885000,667005000,
59593.5,-1518000,-19770115000,35678280000,55448395000,91168615000,789052065.2,1313729891.3,-5.4,99626.1,206.5,2,426300,209900,2848400000,13550,"2023-02-13T14:20:00.000Z",1676298000000,13700,13400,13450,66.3,33.7,0,7.2,2.2,,0.5,216400,642700,6911400,,8734910000,5791655000,2943255000,
59593.5,-1533500,-19977180000,36296395000,56273575000,92696925000,789052065.2,1313729891.3,0.4,99626.1,206.5,0.7,46200,-15500,-207065000,13300,"2023-02-13T14:25:00.000Z",1676298300000,13500,13300,13500,40.5,54,5.5,0.8,0.6,30.5,1.3,61700,114200,7025600,6300,1528310000,618115000,825180000,85015000
59593.5,-1841500,-24135180000,36296395000,60431575000,96854925000,789052065.2,1313729891.3,7.9,99626.1,206.5,0,,-308000,-4158000000,13500,"2023-02-13T14:45:00.000Z",1676299500000,13500,13500,13500,0,100,0,,3.1,,Infinity,308000,308000,7333600,,4158000000,,4158000000,
