"acum_busd","acum_busd_val","acum_val","bu","bu-sd","bu-sd_val","date","datetime","sd","sum_vol","total_vol","uk","val","val_bu","val_sd","val_uk"
24035600,507944894000,3014380949000,83691600,24035600,507944894000,"2022-12-07T09:15:00.000Z",1670404500000,59656000,195555200,195555200,52207600,3014380949000,1373726671000,865781777000,774872501000
33920400,735737021000,4834728321000,59644500,9884800,227792127000,"2022-12-07T09:20:00.000Z",1670404800000,49759700,109833700,305388900,429500,1820347372000,1020779523000,792987396000,6580453000
18214100,495053633000,6214516570000,33046900,-15706300,-240683388000,"2022-12-07T09:25:00.000Z",1670405100000,48753200,82181900,387570800,381800,1379788249000,566531513000,807214901000,6041835000
-3084700,202805726000,7312519684000,23393300,-21298800,-292247907000,"2022-12-07T09:30:00.000Z",1670405400000,44692100,68491900,456062700,406500,1098003114000,399460563000,691708470000,6834081000
18955300,589048662000,8290149739000,39989600,22040000,386242936000,"2022-12-07T09:35:00.000Z",1670405700000,17949600,58234200,514296900,295000,977630055000,679164860000,292921924000,5543271000
36562600,896662969000,9105190973000,32298400,17607300,307614307000,"2022-12-07T09:40:00.000Z",1670406000000,14691100,47166800,561463700,177300,815041234000,559655958000,252041651000,3343625000
39517400,958463050000,9850174136000,25579400,2954800,61800081000,"2022-12-07T09:45:00.000Z",1670406300000,22624600,48395400,609859100,191400,744983163000,401990652000,340190571000,2801940000
35132900,862520309000,10630102913000,21742200,-4384500,-95942741000,"2022-12-07T09:50:00.000Z",1670406600000,26126700,48087800,657946900,218900,779928777000,340223209000,436165950000,3539618000
31265700,829838891000,11175715215000,14017800,-3867200,-32681418000,"2022-12-07T09:55:00.000Z",1670406900000,17885000,32048500,689995400,145700,545612302000,255414524000,288095942000,2101836000
17473500,611118184000,11796631519000,11483800,-13792200,-218720707000,"2022-12-07T10:00:00.000Z",1670407200000,25276000,37058500,727053900,298700,620916304000,199430596000,418151303000,3334405000
-43317200,-315999785000,13085705440000,11595800,-60790700,-927117969000,"2022-12-07T10:05:00.000Z",1670407500000,72386500,84308800,811362700,326500,1289073921000,178857790000,1105975759000,4240372000
-71188900,-716022347000,14220570425000,22672000,-27871700,-400022562000,"2022-12-07T10:10:00.000Z",1670407800000,50543700,73569800,884932500,354100,1134864985000,364348693000,764371255000,6145037000
-61838300,-541276189000,14873683708000,25230200,9350600,174746158000,"2022-12-07T10:15:00.000Z",1670408100000,15879600,41386300,926318800,276500,653113283000,411580466000,236834308000,4698509000
-71726800,-691041159000,15336271180000,9352200,-9888500,-149764970000,"2022-12-07T10:20:00.000Z",1670408400000,19240700,28682700,955001500,89800,462587472000,155843648000,305608618000,1135206000
-103839000,-1178510149000,16127993942000,9012700,-32112200,-487468990000,"2022-12-07T10:25:00.000Z",1670408700000,41124900,50220700,1005222200,83100,791722762000,151663697000,639132687000,926378000
-129796300,-1550152091000,17077130146000,17117800,-25957300,-371641942000,"2022-12-07T10:30:00.000Z",1670409000000,43075100,60468400,1065690600,275500,949136204000,286354903000,657996845000,4784456000
-142185500,-1746051587000,17794690298000,17540900,-12389200,-195899496000,"2022-12-07T10:35:00.000Z",1670409300000,29930100,47561600,1113252200,90600,717560152000,259910906000,455810402000,1838844000
-156358000,-1956571661000,18472309430000,14694800,-14172500,-210520074000,"2022-12-07T10:40:00.000Z",1670409600000,28867300,43883500,1157135700,321400,677619132000,230450407000,440970481000,6198244000
-146208000,-1779432009000,19139783973000,25058200,10150000,177139652000,"2022-12-07T10:45:00.000Z",1670409900000,14908200,40314500,1197450200,348100,667474543000,420121293000,242981641000,4371609000
-132172600,-1535573938000,19690000603000,23235300,14035400,243858071000,"2022-12-07T10:50:00.000Z",1670410200000,9199900,32560200,1230010400,125000,550216630000,395727725000,151869654000,2619251000
-121128700,-1305557824000,20273836474000,20763100,11043900,230016114000,"2022-12-07T10:55:00.000Z",1670410500000,9719200,30702700,1260713100,220400,583835871000,404346263000,174330149000,5159459000
-99980400,-947097633000,21069673377000,35190000,21148300,358460191000,"2022-12-07T11:00:00.000Z",1670410800000,14041700,49681600,1310394700,449900,795836903000,573535844000,215075653000,7225406000
-94275400,-831473871000,21749890440000,21680600,5705000,115623762000,"2022-12-07T11:05:00.000Z",1670411100000,15975600,37837900,1348232600,181700,680217063000,396407679000,280783917000,3025467000
-75938200,-508406660000,22516169523000,31277400,18337200,323067211000,"2022-12-07T11:10:00.000Z",1670411400000,12940200,44285200,1392517800,67600,766279083000,543937587000,220870376000,1471120000
-52320400,-156626947000,23325397929000,36546000,23617800,351779713000,"2022-12-07T11:15:00.000Z",1670411700000,12928200,49598900,1442116700,124700,809228406000,579233118000,227453405000,2541883000
-46712900,-63952581000,23966302698000,21575200,5607500,92674366000,"2022-12-07T11:20:00.000Z",1670412000000,15967700,37682300,1479799000,139400,640904769000,365870386000,273196020000,1838363000
-55856700,-186481187000,24487743328000,10086000,-9143800,-122528606000,"2022-12-07T11:25:00.000Z",1670412300000,19229800,29439200,1509238200,123400,521440630000,198304502000,320833108000,2303020000
-55774200,-185134839000,24489371728000,88800,82500,1346348000,"2022-12-07T11:30:00.000Z",1670412600000,6300,97000,1509335200,1900,1628400000,1419209000,72861000,136330000
-67344100,-304377307000,25768209843000,31658400,-11569900,-119242468000,"2022-12-07T13:00:00.000Z",1670418000000,43228300,76257300,1585592500,1370600,1278838115000,568773540000,688016008000,22048567000
-84631100,-527914678000,26606880265000,16683900,-17287000,-223537371000,"2022-12-07T13:05:00.000Z",1670418300000,33970900,51085900,1636678400,431100,838670422000,303385013000,526922384000,8363025000
-94833000,-646690304000,27583448470000,23585200,-10201900,-118775626000,"2022-12-07T13:10:00.000Z",1670418600000,33787100,57923400,1694601800,551100,976568205000,424895190000,543670816000,8002199000
-91582900,-558258076000,28653799588000,30501700,3250100,88432228000,"2022-12-07T13:15:00.000Z",1670418900000,27251600,58032900,1752634700,279600,1070351118000,576854195000,488421967000,5074956000
-117807200,-988060032000,29646787418000,16127400,-26224300,-429801956000,"2022-12-07T13:20:00.000Z",1670419200000,42351700,58998600,1811633300,519500,992987830000,278194663000,707996619000,6796548000
-145245600,-1399114737000,30892275494000,22947000,-27438400,-411054705000,"2022-12-07T13:25:00.000Z",1670419500000,50385400,73781300,1885414600,448900,1245488076000,413910066000,824964771000,6613239000
-120137500,-995005290000,31933028376000,42997200,25108100,404109447000,"2022-12-07T13:30:00.000Z",1670419800000,17889100,61203100,1946617700,316800,1040752882000,719186693000,315077246000,6488943000
-108969000,-836498767000,33310237376000,45758100,11168500,158506523000,"2022-12-07T13:35:00.000Z",1670420100000,34589600,80992700,2027610400,645000,1377209000000,761991169000,603484646000,11733185000
-110031000,-813706453000,34117452714000,22205300,-1062000,22792314000,"2022-12-07T13:40:00.000Z",1670420400000,23267300,45682200,2073292600,209600,807215338000,413302316000,390510002000,3403020000
-113627400,-881519046000,34839868229000,18701900,-3596400,-67812593000,"2022-12-07T13:45:00.000Z",1670420700000,22298300,41149900,2114442500,149700,722415515000,325925940000,393738533000,2751042000
-140460000,-1317761662000,35724493074000,13035500,-26832600,-436242616000,"2022-12-07T13:50:00.000Z",1670421000000,39868100,53111600,2167554100,208000,884624845000,222245784000,658488400000,3890661000
-162513600,-1624706974000,36898801519000,24314700,-22053600,-306945312000,"2022-12-07T13:55:00.000Z",1670421300000,46368300,71131900,2238686000,448900,1174308445000,430218408000,737163720000,6926317000
-220662900,-2445898264000,38593183832000,23244800,-58149300,-821191290000,"2022-12-07T14:00:00.000Z",1670421600000,81394100,106095500,2344781500,1456600,1694382313000,423906489000,1245097779000,25378045000
-257248600,-2963387729000,40363953160000,38497700,-36585700,-517489465000,"2022-12-07T14:05:00.000Z",1670421900000,75083400,114844700,2459626200,1263600,1770769328000,614779640000,1132269105000,23720583000
-217372800,-2301175846000,41718108762000,59053700,39875800,662211883000,"2022-12-07T14:10:00.000Z",1670422200000,19177900,79284100,2538910300,1052500,1354155602000,998731506000,336519623000,18904473000
-219648400,-2306578622000,42726011479000,27149400,-2275600,-5402776000,"2022-12-07T14:15:00.000Z",1670422500000,29425000,57193000,2596103300,618600,1007902717000,495614792000,501017568000,11270357000
-248971000,-2741162022000,43954280467000,22537900,-29322600,-434583400000,"2022-12-07T14:20:00.000Z",1670422800000,51860500,75585200,2671688500,1186800,1228268988000,386138696000,820722096000,21408196000
-273328700,-3110005417000,45454353792000,31121100,-24357700,-368843395000,"2022-12-07T14:25:00.000Z",1670423100000,55478800,88047100,2759735600,1447200,1500073325000,549726642000,918570037000,31776646000
-273583300,-3113012656000,45487907538000,340800,-254600,-3007239000,"2022-12-07T14:30:00.000Z",1670423400000,595400,2320000,2762055600,1383800,33553746000,5366504000,8373743000,19813499000
-273583800,-3113017656000,45487922538000,500,-500,-5000000,"2022-12-07T14:35:00.000Z",1670423700000,1000,1500,2762057100,0,15000000,5000000,10000000,0
-273588400,-3113063196000,45487968078000,0,-4600,-45540000,"2022-12-07T14:40:00.000Z",1670424000000,4600,4600,2762061700,0,45540000,0,45540000,0
-269589100,-2939036549000,47765860186000,19671500,3999300,174026647000,"2022-12-07T14:45:00.000Z",1670424300000,15672200,118883300,2880945000,83539600,2277892108000,448364982000,274338335000,1555188791000
-269596800,-2939112779000,47765936416000,0,-7700,-76230000,"2022-12-07T14:50:00.000Z",1670424600000,7700,7700,2880952700,0,76230000,0,76230000,0
-269599700,-2939141469000,47765967126000,100,-2900,-28690000,"2022-12-07T14:55:00.000Z",1670424900000,3000,3100,2880955800,0,30710000,1010000,29700000,0
