"acum_busd","acum_busd_val","acum_val","bu","bu-sd","bu-sd_val","date","datetime","sd","sum_vol","total_vol","uk","val","val_bu","val_sd","val_uk"
-416000,-23165340000,512347168000,13497700,-416000,-23165340000,"2022-12-16T09:15:00.000Z",1671182100000,13913700,32632100,32632100,5220700,512347168000,205692281000,228857621000,77797266000
970300,-1424603000,802725442000,9261400,1386300,21740737000,"2022-12-16T09:20:00.000Z",1671182400000,7875100,17222200,49854300,85700,290378274000,155245458000,133504721000,1628095000
89600,-15383202000,1036660277000,6540600,-880700,-13958599000,"2022-12-16T09:25:00.000Z",1671182700000,7421300,14003000,63857300,41100,233934835000,109731036000,123689635000,514164000
16782500,243490851000,1469668143000,21730500,16692900,258874053000,"2022-12-16T09:30:00.000Z",1671183000000,5037600,26865800,90723100,97700,433007866000,345225506000,86351453000,1430907000
26892300,392783758000,1987198048000,20497400,10109800,149292907000,"2022-12-16T09:35:00.000Z",1671183300000,10387600,31107000,121830100,222000,517529905000,331682602000,182389695000,3457608000
24887800,363030292000,2280965527000,7531500,-2004500,-29753466000,"2022-12-16T09:40:00.000Z",1671183600000,9536000,17131600,138961700,64100,293767479000,131507499000,161260965000,999015000
40867000,615759700000,2696564412000,20736200,15979200,252729408000,"2022-12-16T09:45:00.000Z",1671183900000,4757000,25510400,164472100,17200,415598885000,334011603000,81282195000,305087000
47403300,725990697000,2989029152000,11559100,6536300,110230997000,"2022-12-16T09:50:00.000Z",1671184200000,5022800,16633200,181105300,51300,292464740000,201018424000,90787427000,658889000
48217600,745423321000,3276481113000,8594600,814300,19432624000,"2022-12-16T09:55:00.000Z",1671184500000,7780300,16409600,197514900,34700,287451961000,153119064000,133686440000,646457000
45774900,701144357000,3485547887000,5009200,-2442700,-44278964000,"2022-12-16T10:00:00.000Z",1671184800000,7451900,12479100,209994000,18000,209066774000,82144650000,126423614000,498510000
45999600,700338737000,3684365166000,5932800,224700,-805620000,"2022-12-16T10:05:00.000Z",1671185100000,5708100,11692700,221686700,51800,198817279000,98661302000,99466922000,689055000
51641200,776276266000,3921011541000,10172300,5641600,75937529000,"2022-12-16T10:10:00.000Z",1671185400000,4530700,14722600,236409300,19600,236646375000,156132894000,80195365000,318116000
63164600,957590883000,4281223061000,16638800,11523400,181314617000,"2022-12-16T10:15:00.000Z",1671185700000,5115400,21838000,258247300,83800,360211520000,269962756000,88648139000,1600625000
74711000,1144128880000,4684126038000,18316800,11546400,186537997000,"2022-12-16T10:20:00.000Z",1671186000000,6770400,25154600,283401900,67400,402902977000,294017493000,107479496000,1405988000
75761800,1169575970000,4948489642000,8494800,1050800,25447090000,"2022-12-16T10:25:00.000Z",1671186300000,7444000,16004200,299406100,65400,264363604000,144427954000,118980864000,954786000
70785600,1081687856000,5185699870000,4497900,-4976200,-87888114000,"2022-12-16T10:30:00.000Z",1671186600000,9474100,14027200,313433300,55200,237210228000,74120832000,162008946000,1080450000
66768500,1016102160000,5389088123000,3691000,-4017100,-65585696000,"2022-12-16T10:35:00.000Z",1671186900000,7708100,11442200,324875500,43100,203388253000,68478799000,134064495000,844959000
63959100,973703518000,5537261763000,2810100,-2809400,-42398642000,"2022-12-16T10:40:00.000Z",1671187200000,5619500,8458500,333334000,28900,148173640000,52666199000,95064841000,442600000
60600900,929076834000,5702928843000,2928400,-3358200,-44626684000,"2022-12-16T10:45:00.000Z",1671187500000,6286600,9249500,342583500,34500,165667080000,60269007000,104895691000,502382000
57870800,879504387000,5848311589000,2766000,-2730100,-49572447000,"2022-12-16T10:50:00.000Z",1671187800000,5496100,8287800,350871300,25700,145382746000,47712246000,97284693000,385807000
60322800,925619364000,5975326581000,4771500,2452000,46114977000,"2022-12-16T10:55:00.000Z",1671188100000,2319500,7119100,357990400,28100,127014992000,86306787000,40191810000,516395000
59692000,910230085000,6065995767000,2224100,-630800,-15389279000,"2022-12-16T11:00:00.000Z",1671188400000,2854900,5117600,363108000,38600,90669186000,37332622000,52721901000,614663000
59063200,902975931000,6193245729000,3118600,-628800,-7254154000,"2022-12-16T11:05:00.000Z",1671188700000,3747400,6872600,369980600,6600,127249962000,59938596000,67192750000,118616000
56685400,858515827000,6314188148000,2112900,-2377800,-44460104000,"2022-12-16T11:10:00.000Z",1671189000000,4490700,6624800,376605400,21200,120942419000,38125157000,82585261000,232001000
52645400,795517130000,6458060777000,2004900,-4040000,-62998697000,"2022-12-16T11:15:00.000Z",1671189300000,6044900,8066300,384671700,16500,143872629000,40272787000,103271484000,328358000
47702100,721759735000,6619575901000,2421100,-4943300,-73757395000,"2022-12-16T11:20:00.000Z",1671189600000,7364400,9816800,394488500,31300,161515124000,43650011000,117407406000,457707000
43400300,648767797000,6776522778000,2434700,-4301800,-72991938000,"2022-12-16T11:25:00.000Z",1671189900000,6736500,9190000,403678500,18800,156946877000,41757585000,114749523000,439769000
43367500,648274093000,6777131562000,4700,-32800,-493704000,"2022-12-16T11:30:00.000Z",1671190200000,37500,42200,403720700,0,608784000,57540000,551244000,0
39746400,579054129000,7066297865000,6770800,-3621100,-69219964000,"2022-12-16T13:00:00.000Z",1671195600000,10391900,17408700,421129400,246000,289166303000,108405536000,177625500000,3135267000
38580200,543051999000,7279422610000,5522100,-1166200,-36002130000,"2022-12-16T13:05:00.000Z",1671195900000,6688300,12314400,433443800,104000,213124745000,87953260000,123955390000,1216095000
38073100,508439502000,7464578481000,5649400,-507100,-34612497000,"2022-12-16T13:10:00.000Z",1671196200000,6156500,11849800,445293600,43900,185155871000,74998950000,109611447000,545474000
41551900,563984951000,7659753926000,7262700,3478800,55545449000,"2022-12-16T13:15:00.000Z",1671196500000,3783900,11066200,456359800,19600,195175445000,125138115000,69592666000,444664000
45705600,622931324000,7877199497000,8397100,4153700,58946373000,"2022-12-16T13:20:00.000Z",1671196800000,4243400,12655900,469015700,15400,217445571000,137908733000,78962360000,574478000
42772700,561585954000,8071854252000,4105400,-2932900,-61345370000,"2022-12-16T13:25:00.000Z",1671197100000,7038300,11158800,480174500,15100,194654755000,66556545000,127901915000,196295000
31675700,370732882000,8379309300000,3338400,-11097000,-190853072000,"2022-12-16T13:30:00.000Z",1671197400000,14435400,17822100,497996600,48300,307455048000,57923757000,248776829000,754462000
32470700,396923723000,8553915204000,5457200,795000,26190841000,"2022-12-16T13:35:00.000Z",1671197700000,4662200,10128500,508125100,9100,174605904000,100309720000,74118879000,177305000
29347200,346261803000,8734974714000,3643200,-3123500,-50661920000,"2022-12-16T13:40:00.000Z",1671198000000,6766700,10420500,518545600,10600,181059510000,64983452000,115645372000,430686000
30560900,373425840000,8901584726000,5283100,1213700,27164037000,"2022-12-16T13:45:00.000Z",1671198300000,4069400,9373100,527918700,20600,166610012000,96733433000,69569396000,307183000
35895600,484844700000,9146074462000,9160600,5334700,111418860000,"2022-12-16T13:50:00.000Z",1671198600000,3825900,13022400,540941100,35900,244489736000,177703987000,66285127000,500622000
34444300,457677210000,9378342294000,5369600,-1451300,-27167490000,"2022-12-16T13:55:00.000Z",1671198900000,6820900,12210100,553151200,19600,232267832000,102209304000,129376794000,681734000
32878800,434230341000,9579437906000,4239400,-1565500,-23446869000,"2022-12-16T14:00:00.000Z",1671199200000,5804900,10118200,563269400,73900,201095612000,88105805000,111552674000,1437133000
38153200,551594200000,9827142430000,9210500,5274400,117363859000,"2022-12-16T14:05:00.000Z",1671199500000,3936100,13198500,576467900,51900,247704524000,182296100000,64932241000,476183000
42747000,629666757000,10124592844000,10402700,4593800,78072557000,"2022-12-16T14:10:00.000Z",1671199800000,5808900,16269500,592737400,57900,297450414000,187354526000,109281969000,813919000
40933000,589674006000,10413670929000,6315800,-1814000,-39992751000,"2022-12-16T14:15:00.000Z",1671200100000,8129800,14474100,607211500,28500,289078085000,124208475000,164201226000,668384000
33487300,468872113000,10781967222000,6614300,-7445700,-120801893000,"2022-12-16T14:20:00.000Z",1671200400000,14060000,20803600,628015100,129300,368296293000,122646547000,243448440000,2201306000
31790700,449627442000,11151752224000,9337100,-1696600,-19244671000,"2022-12-16T14:25:00.000Z",1671200700000,11033700,20539900,648555000,169100,369785002000,173655998000,192900669000,3228335000
31792600,449518232000,11152112444000,12800,1900,-109210000,"2022-12-16T14:30:00.000Z",1671201000000,10900,23700,648578700,0,360220000,125505000,234715000,0
31798400,449576812000,11152171024000,5800,5800,58580000,"2022-12-16T14:35:00.000Z",1671201300000,0,5800,648584500,0,58580000,58580000,0,0
31800600,449599242000,11152193454000,2200,2200,22430000,"2022-12-16T14:40:00.000Z",1671201600000,0,2200,648586700,0,22430000,22430000,0,0
39818000,657100452000,13540393621000,10830200,8017400,207501210000,"2022-12-16T14:45:00.000Z",1671201900000,2812800,106341400,754928100,92698400,2388200167000,250115025000,42613815000,2095471327000
39790000,656823252000,13540670821000,0,-28000,-277200000,"2022-12-16T14:50:00.000Z",1671202200000,28000,28000,754956100,0,277200000,0,277200000,0
