"acum_busd","acum_busd_val","acum_val","bu","bu-sd","bu-sd_val","date","datetime","sd","sum_vol","total_vol","uk","val","val_bu","val_sd","val_uk"
-3012600,-63572115000,236091446000,3855100,-3012600,-63572115000,"2022-12-16T09:14:00.000Z",1671182040000,6867700,15806600,15806600,5083800,236091446000,48406763000,111978878000,75705805000
-2966000,-64368569000,380501374000,4342600,46600,-796454000,"2022-12-16T09:16:00.000Z",1671182160000,4296000,8736400,24543000,97800,144409928000,71080175000,71876629000,1453124000
-416000,-23165340000,512347168000,5300000,2550000,41203229000,"2022-12-16T09:18:00.000Z",1671182280000,2750000,8089100,32632100,39100,131845794000,86205343000,45002114000,638337000
949300,-2111209000,642461621000,4514100,1365300,21054131000,"2022-12-16T09:20:00.000Z",1671182400000,3148800,7714600,40346700,51700,130114453000,75043412000,53989281000,1081760000
986600,-2623507000,758882836000,3317900,37300,-512298000,"2022-12-16T09:22:00.000Z",1671182520000,3280600,6614200,46960900,15700,116421215000,57835756000,58348054000,237405000
-160800,-18628909000,854604980000,2448900,-1147400,-16005402000,"2022-12-16T09:24:00.000Z",1671182640000,3596300,6090700,53051600,45500,95722144000,39572269000,55577671000,572204000
-667100,-25118008000,940356847000,2354700,-506300,-6489099000,"2022-12-16T09:26:00.000Z",1671182760000,2861000,5221500,58273100,5800,85751867000,39594218000,46083317000,74332000
89600,-15383202000,1036660277000,3166400,756700,9734806000,"2022-12-16T09:28:00.000Z",1671182880000,2409700,5584200,63857300,8100,96303430000,52930839000,43196033000,176558000
2972400,22422672000,1136838956000,4668700,2882800,37805874000,"2022-12-16T09:30:00.000Z",1671183000000,1785900,6462200,70319500,7600,100178679000,68936324000,31130450000,111905000
12450300,170537706000,1360582410000,11680700,9477900,148115034000,"2022-12-16T09:32:00.000Z",1671183120000,2202800,13963300,84282800,79800,223743454000,185344794000,37229760000,1168900000
21327000,315642912000,1592553079000,11315600,8876700,145105206000,"2022-12-16T09:34:00.000Z",1671183240000,2438900,13901500,98184300,147000,231970669000,187401121000,42295915000,2273633000
27210700,406058071000,1827708281000,9875300,5883700,90415159000,"2022-12-16T09:36:00.000Z",1671183360000,3991600,13939400,112123700,72500,235155202000,162270342000,71855183000,1029677000
26892300,392783758000,1987198048000,4687600,-318400,-13274313000,"2022-12-16T09:38:00.000Z",1671183480000,5006000,9706400,121830100,12800,159489767000,72955527000,86229840000,304400000
25308200,363663467000,2102686961000,2510800,-1584100,-29120291000,"2022-12-16T09:40:00.000Z",1671183600000,4094900,6618000,128448100,12300,115488913000,43079243000,72199534000,210136000
24642000,355799812000,2224191547000,3234600,-666200,-7863655000,"2022-12-16T09:42:00.000Z",1671183720000,3900800,7184400,135632500,49000,121504586000,56535226000,64398881000,570479000
26917800,400477111000,2352617094000,4867400,2275800,44677299000,"2022-12-16T09:44:00.000Z",1671183840000,2591600,7463100,143095600,4100,128425547000,86434993000,41757694000,232860000
32636100,491464912000,2517501405000,7911400,5718300,90987801000,"2022-12-16T09:46:00.000Z",1671183960000,2193100,10117000,153212600,12500,164884311000,127862468000,36874667000,147176000
40867000,615759700000,2696564412000,9743500,8230900,124294788000,"2022-12-16T09:48:00.000Z",1671184080000,1512600,11259500,164472100,3400,179063007000,151607172000,27312384000,143451000
43759600,664900072000,2815792672000,4907600,2892600,49140372000,"2022-12-16T09:50:00.000Z",1671184200000,2015000,6926700,171398800,4100,119228260000,84138769000,34998397000,91094000
46602000,713223360000,2933529555000,4666700,2842400,48323288000,"2022-12-16T09:52:00.000Z",1671184320000,1824300,6537300,177936100,46300,117736883000,82762298000,34439010000,535575000
47415400,727079337000,3064475031000,4178200,813400,13855977000,"2022-12-16T09:54:00.000Z",1671184440000,3364800,7561200,185497300,18200,130945476000,72293928000,58437951000,213597000
47791800,742708236000,3180525399000,3518000,376400,15628899000,"2022-12-16T09:56:00.000Z",1671184560000,3141600,6666800,192164100,7200,116050368000,65737625000,50108726000,204017000
48217600,745423321000,3276481113000,2883200,425800,2715085000,"2022-12-16T09:58:00.000Z",1671184680000,2457400,5350800,197514900,10200,95955714000,49204868000,46489783000,261063000
47544700,730541056000,3362204384000,2255400,-672900,-14882265000,"2022-12-16T10:00:00.000Z",1671184800000,2928300,5195000,202709900,11300,85723271000,35271042000,50153307000,298922000
46367800,712007235000,3439112772000,1791900,-1176900,-18533821000,"2022-12-16T10:02:00.000Z",1671184920000,2968800,4767300,207477200,6600,76908388000,29089447000,47623268000,195673000
45649400,700404129000,3519767160000,1916200,-718400,-11603106000,"2022-12-16T10:04:00.000Z",1671185040000,2634600,4564000,212041200,13200,80654388000,34440093000,46043199000,171096000
45464700,696778325000,3600487817000,2285500,-184700,-3625804000,"2022-12-16T10:06:00.000Z",1671185160000,2470200,4785100,216826300,29400,80720657000,38363591000,41989395000,367671000
45999600,700338737000,3684365166000,2693000,534900,3560412000,"2022-12-16T10:08:00.000Z",1671185280000,2158100,4860400,221686700,9300,83877349000,43641779000,40081367000,154203000
47515300,715942052000,3767994930000,3505700,1515700,15603315000,"2022-12-16T10:10:00.000Z",1671185400000,1990000,5497900,227184600,2200,83629764000,49598421000,33995106000,36237000
50699300,762229686000,3872099726000,4700500,3184000,46287634000,"2022-12-16T10:12:00.000Z",1671185520000,1516500,6233300,233417900,16300,104104796000,75067233000,28779599000,257964000
54164700,812786891000,3990037405000,5464600,3465400,50557205000,"2022-12-16T10:14:00.000Z",1671185640000,1999200,7486200,240904100,22400,117937679000,84115470000,33558265000,263944000
57600900,870238039000,4123292658000,5466100,3436200,57451148000,"2022-12-16T10:16:00.000Z",1671185760000,2029900,7502000,248406100,6000,133255253000,95325320000,37874172000,55761000
63164600,957590883000,4281223061000,7674200,5563700,87352844000,"2022-12-16T10:18:00.000Z",1671185880000,2110500,9841200,258247300,56500,157930403000,121989206000,34636362000,1304835000
68590400,1045219921000,4446966848000,7794600,5425800,87629038000,"2022-12-16T10:20:00.000Z",1671186000000,2368800,10173000,268420300,9600,165743787000,126647664000,39018626000,77497000
73774200,1128357438000,4615438034000,7882100,5183800,83137517000,"2022-12-16T10:22:00.000Z",1671186120000,2698300,10619500,279039800,39100,168471186000,125358478000,42220961000,891747000
75651200,1158664990000,4740630667000,4861400,1877000,30307552000,"2022-12-16T10:24:00.000Z",1671186240000,2984400,7907800,286947600,62000,125192633000,77262988000,46955436000,974209000
75642900,1165571500000,4849536336000,3167400,-8300,6906510000,"2022-12-16T10:26:00.000Z",1671186360000,3175700,6347600,293295200,4500,108905669000,57883324000,50976814000,45531000
75761800,1169575970000,4948489642000,3106100,118900,4004470000,"2022-12-16T10:28:00.000Z",1671186480000,2987200,6110900,299406100,17600,98953306000,51292993000,47288523000,371790000
73950300,1132682306000,5046812594000,1892900,-1811500,-36893664000,"2022-12-16T10:30:00.000Z",1671186600000,3704400,5605500,305011600,8200,98322952000,30646074000,67539738000,137140000
71283000,1089780975000,5144997073000,1714200,-2667300,-42901331000,"2022-12-16T10:32:00.000Z",1671186720000,4381500,6111500,311123100,15800,98184479000,27466979000,70368310000,349190000
69826300,1068194915000,5223641137000,1512800,-1456700,-21586060000,"2022-12-16T10:34:00.000Z",1671186840000,2969500,4513500,315636600,31200,78644064000,28231942000,49818002000,594120000
67792900,1033490528000,5323322289000,1818100,-2033400,-34704387000,"2022-12-16T10:36:00.000Z",1671186960000,3851500,5693900,321330500,24300,99681152000,32256131000,66960518000,464503000
66768500,1016102160000,5389088123000,1250900,-1024400,-17388368000,"2022-12-16T10:38:00.000Z",1671187080000,2275300,3545000,324875500,18800,65765834000,23998505000,41386873000,380456000
65597700,997509775000,5449929823000,1206300,-1170800,-18592385000,"2022-12-16T10:40:00.000Z",1671187200000,2377100,3590000,328465500,6600,60841700000,21092554000,39684939000,64207000
64768900,987033198000,5508420729000,1188500,-828800,-10476577000,"2022-12-16T10:42:00.000Z",1671187320000,2017300,3217800,331683300,12000,58490906000,23888163000,34364740000,238003000
62994100,961803172000,5567031597000,835400,-1774800,-25230026000,"2022-12-16T10:44:00.000Z",1671187440000,2610200,3456100,335139400,10500,58610868000,16614406000,41844432000,152030000
62075800,947684104000,5628386268000,1206000,-918300,-14119068000,"2022-12-16T10:46:00.000Z",1671187560000,2124300,3333400,338472800,3100,61354671000,23607482000,37726550000,20639000
60600900,929076834000,5702928843000,1302300,-1474900,-18607270000,"2022-12-16T10:48:00.000Z",1671187680000,2777200,4110700,342583500,31200,74542575000,27732601000,46339871000,470103000
59127400,898762593000,5766548203000,1028300,-1473500,-30314241000,"2022-12-16T10:50:00.000Z",1671187800000,2501800,3542500,346126000,12400,63619360000,16582727000,46896968000,139665000
58257700,886905231000,5820040614000,1205400,-869700,-11857362000,"2022-12-16T10:52:00.000Z",1671187920000,2075100,3283200,349409200,2700,53492411000,20768692000,32626054000,97665000
58739100,895109537000,5880780087000,1844600,481400,8204306000,"2022-12-16T10:54:00.000Z",1671188040000,1363200,3220600,352629800,12800,60739473000,34364893000,26160587000,213993000
59481700,904622587000,5929777562000,1874000,742600,9513050000,"2022-12-16T10:56:00.000Z",1671188160000,1131400,3018900,355648700,13500,48997475000,29099113000,19586063000,312299000
60322800,925619364000,5975326581000,1585200,841100,20996777000,"2022-12-16T10:58:00.000Z",1671188280000,744100,2341700,357990400,12400,45549019000,33203608000,12206831000,138580000
60134400,922306361000,6013610645000,934100,-188400,-3313003000,"2022-12-16T11:00:00.000Z",1671188400000,1122500,2084700,360075100,28100,38284064000,17293959000,20606962000,383143000
59648800,912018569000,6049049065000,718000,-485600,-10287792000,"2022-12-16T11:02:00.000Z",1671188520000,1203600,1931100,362006200,9500,35438420000,12461959000,22749751000,226710000
59867200,911627867000,6094007868000,1484000,218400,-390702000,"2022-12-16T11:04:00.000Z",1671188640000,1265600,2752400,364758600,2800,44958803000,22271963000,22662665000,24175000
59429300,909265298000,6150086218000,1150700,-437900,-2362569000,"2022-12-16T11:06:00.000Z",1671188760000,1588600,2743600,367502200,4300,56078350000,26817720000,29180289000,80341000
59063200,902975931000,6193245729000,1055900,-366100,-6289367000,"2022-12-16T11:08:00.000Z",1671188880000,1422000,2478400,369980600,500,43159511000,18425617000,24714984000,18910000
58219000,883788006000,6245043085000,974700,-844200,-19187925000,"2022-12-16T11:10:00.000Z",1671189000000,1818900,2799300,372779900,5700,51797356000,16276993000,35464918000,55445000
57018200,864904640000,6294724929000,782200,-1200800,-18883366000,"2022-12-16T11:12:00.000Z",1671189120000,1983000,2780600,375560500,15400,49681844000,15319886000,34203252000,158706000
56070300,849059372000,6343997422000,893400,-947900,-15845268000,"2022-12-16T11:14:00.000Z",1671189240000,1841300,2736700,378297200,2000,49272493000,16695104000,32540372000,37017000
55214300,840435853000,6382357130000,749700,-856000,-8623519000,"2022-12-16T11:16:00.000Z",1671189360000,1605700,2355800,380653000,400,38359708000,14859957000,23483476000,16275000.000000002
52645400,795517130000,6458060777000,717800,-2568900,-44918723000,"2022-12-16T11:18:00.000Z",1671189480000,3286700,4018700,384671700,14200,75703647000,15246004000,60164727000,292916000
48811000,742222766000,6547428202000,897900,-3834400,-53294364000,"2022-12-16T11:20:00.000Z",1671189600000,4732300,5633800,390305500,3600,89367425000,18024222000,71318586000,24617000
48343300,732671971000,6590232537000,1043300,-467700,-9550795000,"2022-12-16T11:22:00.000Z",1671189720000,1511000,2573800,392879300,19500,42804335000,16496120000,26046915000,261300000
47323600,713507676000,6641117752000,930400,-1019700,-19164295000,"2022-12-16T11:24:00.000Z",1671189840000,1950100,2890900,395770200,10400,50885215000,15759730000,34924025000,201460000
45684400,685251358000,6705048006000,1063000,-1639200,-28256318000,"2022-12-16T11:26:00.000Z",1671189960000,2702200,3767000,399537200,1800,63930254000,17820852000,46077170000,32232000
43400300,648767797000,6776522778000,921200,-2284100,-36483561000,"2022-12-16T11:28:00.000Z",1671190080000,3205300,4141300,403678500,14800,71474772000,17306672000,53790233000,377867000
43367500,648274093000,6777131562000,4700,-32800,-493704000,"2022-12-16T11:30:00.000Z",1671190200000,37500,42200,403720700,0,608784000,57540000,551244000,0
39375500,578094038000,6951196750000,3199500,-3992000,-70180055000,"2022-12-16T13:00:00.000Z",1671195600000,7191500,10630600,414351300,239600,174065188000,50470263000,120650318000,2944607000
38955100,569075027000,7020218594000,1755600,-420400,-9019011000,"2022-12-16T13:02:00.000Z",1671195720000,2176000,3933800,418285100,2200,69021844000,29942224000,38961235000,118385000
39602700,577085710000,7108740115000,2895000,647600,8010683000,"2022-12-16T13:04:00.000Z",1671195840000,2247400,5205600,423490700,63200,88521521000,47808162000,39797479000,915880000
39211100,566433400000,7185474708000,2209800,-391600,-10652310000,"2022-12-16T13:06:00.000Z",1671195960000,2601400,4841700,428332400,30500,76734593000,32928309000,43580619000,225665000
38580200,543051999000,7279422610000,2233000,-630900,-23381401000,"2022-12-16T13:08:00.000Z",1671196080000,2863900,5111400,433443800,14500,93947902000,35209838000,58591239000,146825000
38142400,520609949000,7350184720000,1826900,-437800,-22442050000,"2022-12-16T13:10:00.000Z",1671196200000,2264700,4102900,437546700,11300,70762110000,24124480000,46566530000,71100000
37959900,507415648000,7430035889000,2708400,-182500,-13194301000,"2022-12-16T13:12:00.000Z",1671196320000,2890900,5622700,443169400,23400,79851169000,33173844000,46368145000,309180000
38399100,512431069000,7498335114000,2261200,439200,5015421000,"2022-12-16T13:14:00.000Z",1671196440000,1822000,4093600,447263000,10400,68299225000,36564034000,31548613000,186578000
39179200,522611558000,7569217947000,2356500,780100,10180489000,"2022-12-16T13:16:00.000Z",1671196560000,1576400,3938000,451201000,5100,70882833000,40405286000,30224797000,252750000
41551900,563984951000,7659753926000,3759100,2372700,41373393000,"2022-12-16T13:18:00.000Z",1671196680000,1386400,5158800,456359800,13300,90535979000,65869421000,24496028000,170530000
44162800,596019154000,7759017659000,4225700,2610900,32034203000,"2022-12-16T13:20:00.000Z",1671196800000,1614800,5852900,462212700,12400,99263733000,65407336000,33373133000,483264000
45168400,614404735000,7829261594000,2632600,1005600,18385581000,"2022-12-16T13:22:00.000Z",1671196920000,1627000,4261400,466474100,1800,70243935000,44299331000,25913750000,30854000
45836200,619763470000,7915856310000,2690200,667800,5358735000,"2022-12-16T13:24:00.000Z",1671197040000,2022400,4718100,471192200,5500,86594716000,45915438000,40556703000,122575000
44961500,607672327000,7987909335000,1754100,-874700,-12091143000,"2022-12-16T13:26:00.000Z",1671197160000,2628800,4386600,475578800,3700,72053025000,29956321000,42047464000,49240000
42772700,561585954000,8071854252000,1199900,-2188800,-46086373000,"2022-12-16T13:28:00.000Z",1671197280000,3388700,4595700,480174500,7100,83944917000,18886852000,64973225000,84840000
38240500,479782831000,8198763693000,1275900,-4532200,-81803123000,"2022-12-16T13:30:00.000Z",1671197400000,5808100,7090500,487265000,6500,126909441000,22493541000,104296664000,119236000
33684500,408251518000,8310388147000,1188900,-4556000,-71531313000,"2022-12-16T13:32:00.000Z",1671197520000,5744900,6963900,494228900,30100,111624454000,19823210000,91354523000,446721000
31736500,373317999000,8414732237000,1940700,-1948000,-34933519000,"2022-12-16T13:34:00.000Z",1671197640000,3888700,5846400,500075300,17000,104344090000,34572143000,69505662000,266285000
31922500,380312956000,8487052162000,2360600,186000,6994957000,"2022-12-16T13:36:00.000Z",1671197760000,2174600,4537700,504613000,2500,72319925000,39615531000,32620574000,83820000
32470700,396923723000,8553915204000,2029500,548200,16610767000,"2022-12-16T13:38:00.000Z",1671197880000,1481300,3512100,508125100,1300,66863042000,41729052000,25118285000,15705000
31897000,388743581000,8616706557000,1569000,-573700,-8180142000,"2022-12-16T13:40:00.000Z",1671198000000,2142700,3719400,511844500,7700,62791353000,27144330000,35324472000,322551000
29981200,353371134000,8704219903000,1456800,-1915800,-35372447000,"2022-12-16T13:42:00.000Z",1671198120000,3372600,4832100,516676600,2700,87513346000,26019167000,61391614000,102565000
29392500,348992900000,8758445535000,1310800,-588700,-4378234000,"2022-12-16T13:44:00.000Z",1671198240000,1899500,3211100,519887700,800,54225632000,24893094000,29271328000,61210000
29866500,359654515000,8823830295000,2033000,474000,10661615000,"2022-12-16T13:46:00.000Z",1671198360000,1559000,3610500,523498200,18500,65384760000,37903736000,27242121000,238903000
30560900,373425840000,8901584726000,2556700,694400,13771325000,"2022-12-16T13:48:00.000Z",1671198480000,1862300,4420500,527918700,1500,77754431000,45756558000,31985233000,12640000
32241500,408850322000,8991176766000,3235300,1680600,35424482000,"2022-12-16T13:50:00.000Z",1671198600000,1554700,4798700,532717400,8700,89592040000,62451022000,27026540000,114478000
34248200,454625753000,9089124037000,3609400,2006700,45775431000,"2022-12-16T13:52:00.000Z",1671198720000,1602700,5229700,537947100,17600,97947271000,71751281000,25975850000,220140000
36971900,505557548000,9198033380000,4190100,2723700,50931795000,"2022-12-16T13:54:00.000Z",1671198840000,1466400,5667100,543614200,10600,108909343000,79814997000,28883202000,211144000
36615200,495841598000,9291720329000,2268900,-356700,-9715950000,"2022-12-16T13:56:00.000Z",1671198960000,2625600,4903600,548517800,9100,93686949000,41826960000,51542910000,317079000
34444300,457677210000,9378342294000,1226500,-2170900,-38164388000,"2022-12-16T13:58:00.000Z",1671199080000,3397400,4633400,553151200,9500,86621965000,24069031000,62233419000,319515000
33838200,446779656000,9463694513000,1835100,-606100,-10897554000,"2022-12-16T14:00:00.000Z",1671199200000,2441200,4308100,557459300,31800,85352219000,36964448000,47862002000,525769000
33291600,440872788000,9541858799000,1653100,-546600,-5906868000,"2022-12-16T14:02:00.000Z",1671199320000,2199700,3887200,561346500,34400,78164286000,35703529000,41610397000,850360000
33655900,451502197000,9621735970000,2244900,364300,10629409000,"2022-12-16T14:04:00.000Z",1671199440000,1880600,4137800,565484300,12300,79877171000,45190878000,34561469000,124824000
34774400,482120988000,9705723340000,2912100,1118500,30618791000,"2022-12-16T14:06:00.000Z",1671199560000,1793600,4734900,570219200,29200,83987370000,57165892000,26547101000,274377000
38153200,551594200000,9827142430000,4804700,3378800,69473212000,"2022-12-16T14:08:00.000Z",1671199680000,1425900,6248700,576467900,18100,121419090000,95377158000,25903946000,137986000
41577400,609503359000,9947138886000,4921400,3424200,57909159000,"2022-12-16T14:10:00.000Z",1671199800000,1497200,6436300,582904200,17700,119996456000,88803543000,30894384000,298529000
42869800,632817913000,10082306615000,4509300,1292400,23314554000,"2022-12-16T14:12:00.000Z",1671199920000,3216900,7764200,590668400,38000,135167729000,79009924000,55695370000,462435000
43189800,641478830000,10174638093000,2337800,320000,8660917000,"2022-12-16T14:14:00.000Z",1671200040000,2017800,4360200,595028600,4600,92331478000,50436504000,41775587000,119387000
43038700,626607153000,10283944769000,2657400,-151100,-14871677000,"2022-12-16T14:16:00.000Z",1671200160000,2808500,5476900,600505500,11000,109306676000,47075399000,61947076000,284201000
40933000,589674006000,10413670929000,2292600,-2105700,-36933147000,"2022-12-16T14:18:00.000Z",1671200280000,4398300,6706000,607211500,15100,129726160000,46237631000,83170778000,317751000
36052000,511007470000,10577684147000,2148500,-4881000,-78666536000,"2022-12-16T14:20:00.000Z",1671200400000,7029500,9228000,616439500,50000,164013218000,42198436000,120864972000,949810000
32829300,456087603000,10714938738000,2304700,-3222700,-54919867000,"2022-12-16T14:22:00.000Z",1671200520000,5527400,7889300,624328800,57200,137254591000,40663175000,95583042000,1008374000
33378500,469225368000,10846780833000,3734200,549200,13137765000,"2022-12-16T14:24:00.000Z",1671200640000,3185000,6958200,631287000,39000,131842095000,72085890000,58948125000,808080000
33192700,475872994000,10990805842000,3583000,-185800,6647626000,"2022-12-16T14:26:00.000Z",1671200760000,3768800,7463800,638750800,112000,144025009000,74356450000,67708824000,1959734999.9999998
31790700,449627442000,11151752224000,4181000,-1402000,-26245552000,"2022-12-16T14:28:00.000Z",1671200880000,5583000,9804200,648555000,40200,160946382000,66998594000,93244146000,703642000
31792600,449518232000,11152112444000,12800,1900,-109210000,"2022-12-16T14:30:00.000Z",1671201000000,10900,23700,648578700,0,360220000,125505000,234715000,0
31797600,449568732000,11152162944000,5000,5000,50500000,"2022-12-16T14:36:00.000Z",1671201360000,0,5000,648583700,0,50500000,50500000,0,0
31798400,449576812000,11152171024000,800,800,8080000,"2022-12-16T14:38:00.000Z",1671201480000,0,800,648584500,0,8080000,8080000,0,0
31798600,449578842000,11152173054000,200,200,2030000,"2022-12-16T14:42:00.000Z",1671201720000,0,200,648584700,0,2030000,2030000,0,0
39818500,657105502000,13540388571000,10832200,8019900,207526660000,"2022-12-16T14:44:00.000Z",1671201840000,2812300,106342900,754927600,92698400,2388215517000,250135425000,42608765000,2095471327000
39818000,657100452000,13540393621000,0,-500,-5050000,"2022-12-16T14:48:00.000Z",1671202080000,500,500,754928100,0,5050000,0,5050000,0
39790000,656823252000,13540670821000,0,-28000,-277200000,"2022-12-16T14:50:00.000Z",1671202200000,28000,28000,754956100,0,277200000,0,277200000,0
