"acum_busd","acum_busd_val","acum_val_bu","acum_val_sd","acum_val","accum_bu","accum_sd","avg_val_bu","avg_val_sd","avg_val","avg_vol","avg_bu","avg_sd","avg_busd","avg_busd_val","rbusd","bu","bu-sd","bu-sd_val","date","datetime","sd","sum_vol","total_vol","uk","val","val_bu","val_sd","val_uk"
-3012600,-55237857600,43347427400,98585285000,202043927600,3855100,6867700,43486573649.6,39842980124,100053895917.4,6239306.6,2869669.4,2540826.4,328843,3643593525.6,15.2,3855100,-3012600,-55237857600,"2022-12-16T09:14:00.000Z",1671182040000,6867700,15806600,15806600,5083800,202043927600,43347427400,98585285000,60111215200
-2966000,-49547405000,108558377500,158105782500,328112815000,8197700,11163700,43486573649.6,39842980124,100053895917.4,6239306.6,2869669.4,2540826.4,328843,3643593525.6,1.6,4342600,46600,5690452600,"2022-12-16T09:16:00.000Z",1671182160000,4296000,8736400,24543000,97800,126068887400,65210950100,59520497500,1337439800
-416000,-17460150900,183394001600,200854152500,446335146100,13497700,13913700,43486573649.6,39842980124,100053895917.4,6239306.6,2869669.4,2540826.4,328843,3643593525.6,8.8,5300000,2550000,32087254100,"2022-12-16T09:18:00.000Z",1671182280000,2750000,8089100,32632100,39100,118222331100,74835624100,42748370000,638337000
949300,43234400,251652205600,251608971200,566429928800,18011800,17062500,43486573649.6,39842980124,100053895917.4,6239306.6,2869669.4,2540826.4,328843,3643593525.6,4.8,4514100,1365300,17503385300,"2022-12-16T09:20:00.000Z",1671182400000,3148800,7714600,40346700,51700,120094782700,68258204000,50754818700,1081760000
986600,-2134596400,304970883200,307105479600,675480721600,21329700,20343100,43486573649.6,39842980124,100053895917.4,6239306.6,2869669.4,2540826.4,328843,3643593525.6,0.6,3317900,37300,-2177830800,"2022-12-16T09:22:00.000Z",1671182520000,3280600,6614200,46960900,15700,109050792800,53318677600,55496508400,235606800
-160800,-17586852100,340407791700,357994643800,762378998300,23778600,23939400,43486573649.6,39842980124,100053895917.4,6239306.6,2869669.4,2540826.4,328843,3643593525.6,4.2,2448900,-1147400,-15452255700,"2022-12-16T09:24:00.000Z",1671182640000,3596300,6090700,53051600,45500,86898276700,35436908500,50889164200,572204000
-667100,-23744582800,379120092500,402864675300,846035662600,26133300,26800400,43486573649.6,39842980124,100053895917.4,6239306.6,2869669.4,2540826.4,328843,3643593525.6,1.7,2354700,-506300,-6157730700,"2022-12-16T09:26:00.000Z",1671182760000,2861000,5221500,58273100,5800,83656664300,38712300800,44870031500,74332000
89600,-20418361800,425276013200,445694375000,935197841000,29299700,29210100,43486573649.6,39842980124,100053895917.4,6239306.6,2869669.4,2540826.4,328843,3643593525.6,0.9,3166400,756700,3326221000,"2022-12-16T09:28:00.000Z",1671182880000,2409700,5584200,63857300,8100,89162178400,46155920700,42829699700,176558000
2972400,2292122700,478520644600,476228521900,1019088524300,33968400,30996000,43486573649.6,39842980124,100053895917.4,6239306.6,2869669.4,2540826.4,328843,3643593525.6,6.2,4668700,2882800,22710484500,"2022-12-16T09:30:00.000Z",1671183000000,1785900,6462200,70319500,7600,83890683300,53244631400,30534146900,111905000
12450300,137316260700,650065252600,512748991900,1228313711100,45649100,33198800,43486573649.6,39842980124,100053895917.4,6239306.6,2869669.4,2540826.4,328843,3643593525.6,37.1,11680700,9477900,135024138000,"2022-12-16T09:32:00.000Z",1671183120000,2202800,13963300,84282800,79800,209225186800,171544608000,36520470000,1160108800
21327000,260180030400,812920344200,552740313800,1433399991400,56964700,35637700,43486573649.6,39842980124,100053895917.4,6239306.6,2869669.4,2540826.4,328843,3643593525.6,33.7,11315600,8876700,122863769700,"2022-12-16T09:34:00.000Z",1671183240000,2438900,13901500,98184300,147000,205086280300,162855091600,39991321900,2239866800
27210700,324640669900,945035571500,620394901600,1634199483500,66840000,39629300,43486573649.6,39842980124,100053895917.4,6239306.6,2869669.4,2540826.4,328843,3643593525.6,17.7,9875300,5883700,64460639500,"2022-12-16T09:36:00.000Z",1671183360000,3991600,13939400,112123700,72500,200799492100,132115227300,67654587800,1029677000
26892300,317156560900,1010179118300,693022557400,1772275086100,71527600,44635300,43486573649.6,39842980124,100053895917.4,6239306.6,2869669.4,2540826.4,328843,3643593525.6,2.1,4687600,-318400,-7484109000,"2022-12-16T09:38:00.000Z",1671183480000,5006000,9706400,121830100,12800,138075602600,65143546800,72627655800,304400000
25308200,294307292600,1045900027000,751592734400,1866632551700,74038400,48730200,43486573649.6,39842980124,100053895917.4,6239306.6,2869669.4,2540826.4,328843,3643593525.6,6.3,2510800,-1584100,-22849268300,"2022-12-16T09:40:00.000Z",1671183600000,4094900,6618000,128448100,12300,94357465600,35720908700,58570177000,66379900
24642000,289836341500,1085359445900,795523104400,1950333479200,77273000,52631000,43486573649.6,39842980124,100053895917.4,6239306.6,2869669.4,2540826.4,328843,3643593525.6,1.2,3234600,-666200,-4470951100,"2022-12-16T09:42:00.000Z",1671183720000,3900800,7184400,135632500,49000,83700927500,39459418900,43930370000,311138600
26917800,332938417300,1164446294400,831507877100,2065419778800,82140400,55222600,43486573649.6,39842980124,100053895917.4,6239306.6,2869669.4,2540826.4,328843,3643593525.6,11.8,4867400,2275800,43102075800,"2022-12-16T09:44:00.000Z",1671183840000,2591600,7463100,143095600,4100,115086299600,79086848500,35984772700,14678400
32636100,421558088800,1287956519000,866398430200,2223967732500,90051800,57415700,43486573649.6,39842980124,100053895917.4,6239306.6,2869669.4,2540826.4,328843,3643593525.6,24.3,7911400,5718300,88619671500,"2022-12-16T09:46:00.000Z",1671183960000,2193100,10117000,153212600,12500,158547953700,123510224600,34890553100,147176000
40867000,538387649500,1430981082200,892593432700,2393330749200,99795300,58928300,43486573649.6,39842980124,100053895917.4,6239306.6,2869669.4,2540826.4,328843,3643593525.6,32.1,9743500,8230900,116829560700,"2022-12-16T09:48:00.000Z",1671184080000,1512600,11259500,164472100,3400,169363016700,143024563200,26195002500,143451000
43759600,585347404300,1510061714400,924714310100,2504623352800,104702900,60943300,43486573649.6,39842980124,100053895917.4,6239306.6,2869669.4,2540826.4,328843,3643593525.6,12.9,4907600,2892600,46959754800,"2022-12-16T09:50:00.000Z",1671184200000,2015000,6926700,171398800,4100,111292603600,79080632200,32120877400,91094000
46602000,630997368300,1587081560600,956084192300,2613548656200,109369600,62767600,43486573649.6,39842980124,100053895917.4,6239306.6,2869669.4,2540826.4,328843,3643593525.6,12.5,4666700,2842400,45649964000,"2022-12-16T09:52:00.000Z",1671184320000,1824300,6537300,177936100,46300,108925303400,77019846200,31369882200,535575000
47415400,648054740700,1657331334800,1009276594100,2737197536100,113547800,66132400,43486573649.6,39842980124,100053895917.4,6239306.6,2869669.4,2540826.4,328843,3643593525.6,4.7,4178200,813400,17057372400,"2022-12-16T09:54:00.000Z",1671184440000,3364800,7561200,185497300,18200,123648879900,70249774200,53192401800,206703900
47791800,664008614400,1717383351100,1053374736700,2841551712000,117065800,69274000,43486573649.6,39842980124,100053895917.4,6239306.6,2869669.4,2540826.4,328843,3643593525.6,4.4,3518000,376400,15953873700,"2022-12-16T09:56:00.000Z",1671184560000,3141600,6666800,192164100,7200,104354175900,60052016300,44098142600,204017000
48217600,664038187600,1759608605700,1095570418100,2926233711000,119949000,71731400,43486573649.6,39842980124,100053895917.4,6239306.6,2869669.4,2540826.4,328843,3643593525.6,0,2883200,425800,29573200,"2022-12-16T09:58:00.000Z",1671184680000,2457400,5350800,197514900,10200,84681999000,42225254600,42195681400,261063000
47544700,650496780400,1791270660300,1140773879900,3003374772800,122204400,74659700,43486573649.6,39842980124,100053895917.4,6239306.6,2869669.4,2540826.4,328843,3643593525.6,3.7,2255400,-672900,-13541407200,"2022-12-16T10:00:00.000Z",1671184800000,2928300,5195000,202709900,11300,77141061800,31662054600,45203461800,275545400
46367800,634524695100,1816911059800,1182386364700,3070814538900,123996300,77628500,43486573649.6,39842980124,100053895917.4,6239306.6,2869669.4,2540826.4,328843,3643593525.6,4.4,1791900,-1176900,-15972085300,"2022-12-16T10:02:00.000Z",1671184920000,2968800,4767300,207477200,6600,67439766100,25640399500,41612484800,186881800
45649400,624788320500,1846286222800,1221497902300,3139472335500,125912500,80263100,43486573649.6,39842980124,100053895917.4,6239306.6,2869669.4,2540826.4,328843,3643593525.6,2.7,1916200,-718400,-9736374600,"2022-12-16T10:04:00.000Z",1671185040000,2634600,4564000,212041200,13200,68657796600,29375163000,39111537600,171096000
45464700,616262921000,1876019852400,1259756931400,3207832665200,128198000,82733300,43486573649.6,39842980124,100053895917.4,6239306.6,2869669.4,2540826.4,328843,3643593525.6,2.3,2285500,-184700,-8525399500,"2022-12-16T10:06:00.000Z",1671185160000,2470200,4785100,216826300,29400,68360329700,29733629600,38259029100,367671000
45999600,616319840000,1912939260500,1296619420500,3281768765400,130891000,84891400,43486573649.6,39842980124,100053895917.4,6239306.6,2869669.4,2540826.4,328843,3643593525.6,0,2693000,534900,56919000,"2022-12-16T10:08:00.000Z",1671185280000,2158100,4860400,221686700,9300,73936100200,36919408100,36862489100,154203000
47515300,629396883800,1958540682500,1329143798700,3359930802600,134396700,86881400,43486573649.6,39842980124,100053895917.4,6239306.6,2869669.4,2540826.4,328843,3643593525.6,3.6,3505700,1515700,13077043800,"2022-12-16T10:10:00.000Z",1671185400000,1990000,5497900,227184600,2200,78162037200,45601422000,32524378200,36237000
50699300,668326183500,2022272162600,1353945979100,3448714035500,139097200,88397900,43486573649.6,39842980124,100053895917.4,6239306.6,2869669.4,2540826.4,328843,3643593525.6,10.7,4700500,3184000,38929299700,"2022-12-16T10:12:00.000Z",1671185520000,1516500,6233300,233417900,16300,88783232900,63731480100,24802180400,249572400
54164700,706635149000,2093626606400,1386991457400,3553377901600,144561800,90397100,43486573649.6,39842980124,100053895917.4,6239306.6,2869669.4,2540826.4,328843,3643593525.6,10.5,5464600,3465400,38308965500,"2022-12-16T10:14:00.000Z",1671185640000,1999200,7486200,240904100,22400,104663866100,71354443800,33045478300,263944000
57600900,759132455800,2182294090900,1423161635100,3678271324800,150027900,92427000,43486573649.6,39842980124,100053895917.4,6239306.6,2869669.4,2540826.4,328843,3643593525.6,14.4,5466100,3436200,52497306800,"2022-12-16T10:16:00.000Z",1671185760000,2029900,7502000,248406100,6000,124893423200,88667484500,36170177700,55761000
63164600,818776336500,2273586024900,1454809688400,3802516147100,157702100,94537500,43486573649.6,39842980124,100053895917.4,6239306.6,2869669.4,2540826.4,328843,3643593525.6,16.4,7674200,5563700,59643880700,"2022-12-16T10:18:00.000Z",1671185880000,2110500,9841200,258247300,56500,124244822300,91291934000,31648053300,1304835000
68590400,895460130700,2385931805100,1490471674400,3950601410300,165496700,96906300,43486573649.6,39842980124,100053895917.4,6239306.6,2869669.4,2540826.4,328843,3643593525.6,21,7794600,5425800,76683794200,"2022-12-16T10:20:00.000Z",1671186000000,2368800,10173000,268420300,9600,148085263200,112345780200,35661986000,77497000
73774200,975274574100,2505190688800,1529916114700,4110196481300,173378800,99604600,43486573649.6,39842980124,100053895917.4,6239306.6,2869669.4,2540826.4,328843,3643593525.6,21.9,7882100,5183800,79814443400,"2022-12-16T10:22:00.000Z",1671186120000,2698300,10619500,279039800,39100,159595071000,119258883700,39444440300,891747000
75651200,1004338271200,2580141091700,1575802820500,4232007799000,178240200,102589000,43486573649.6,39842980124,100053895917.4,6239306.6,2869669.4,2540826.4,328843,3643593525.6,8,4861400,1877000,29063697100,"2022-12-16T10:24:00.000Z",1671186240000,2984400,7907800,286947600,62000,121811317700,74950402900,45886705800,974209000
75642900,1016327793100,2633667676800,1617339883700,4327116978300,181407600,105764700,43486573649.6,39842980124,100053895917.4,6239306.6,2869669.4,2540826.4,328843,3643593525.6,3.3,3167400,-8300,11989521900,"2022-12-16T10:26:00.000Z",1671186360000,3175700,6347600,293295200,4500,95109179300,53526585100,41537063200,45531000
75761800,1023551940200,2682313219900,1658761279700,4417391371900,184513700,108751900,43486573649.6,39842980124,100053895917.4,6239306.6,2869669.4,2540826.4,328843,3643593525.6,2,3106100,118900,7224147100,"2022-12-16T10:28:00.000Z",1671186480000,2987200,6110900,299406100,17600,90274393600,48645543100,41421396000,207454500
73950300,989641989500,2711409245500,1721767256000,4509630513800,186406600,112456300,43486573649.6,39842980124,100053895917.4,6239306.6,2869669.4,2540826.4,328843,3643593525.6,9.3,1892900,-1811500,-33909950700,"2022-12-16T10:30:00.000Z",1671186600000,3704400,5605500,305011600,8200,92239141900,29096025600,63005976300,137140000
71283000,951368725800,2735910992700,1784542266900,4597255363000,188120800,116837800,43486573649.6,39842980124,100053895917.4,6239306.6,2869669.4,2540826.4,328843,3643593525.6,10.5,1714200,-2667300,-38273263700,"2022-12-16T10:32:00.000Z",1671186720000,4381500,6111500,311123100,15800,87624849200,24501747200,62775010900,348091100
69826300,931404941900,2762097981700,1830693039800,4670187244900,189633600,119807300,43486573649.6,39842980124,100053895917.4,6239306.6,2869669.4,2540826.4,328843,3643593525.6,5.5,1512800,-1456700,-19963783900,"2022-12-16T10:34:00.000Z",1671186840000,2969500,4513500,315636600,31200,72931881900,26186989000,46150772900,594120000
67792900,900611739800,2793125043000,1892513303200,4763499072600,191451700,123658800,43486573649.6,39842980124,100053895917.4,6239306.6,2869669.4,2540826.4,328843,3643593525.6,8.5,1818100,-2033400,-30793202100,"2022-12-16T10:36:00.000Z",1671186960000,3851500,5693900,321330500,24300,93311827700,31027061300,61820263400,464503000
66768500,885441751200,2815760912000,1930319160800,4824321255200,192702600,125934100,43486573649.6,39842980124,100053895917.4,6239306.6,2869669.4,2540826.4,328843,3643593525.6,4.2,1250900,-1024400,-15169988600,"2022-12-16T10:38:00.000Z",1671187080000,2275300,3545000,324875500,18800,60822182600,22635869000,37805857600,380456000
65597700,866810105500,2836079640600,1969269535100,4883654565100,193908900,128311200,43486573649.6,39842980124,100053895917.4,6239306.6,2869669.4,2540826.4,328843,3643593525.6,5.1,1206300,-1170800,-18631645700,"2022-12-16T10:40:00.000Z",1671187200000,2377100,3590000,328465500,6600,59333309900,20318728600,38950374300,64207000
64768900,859822036500,2858965407000,1999143370500,4936652169900,195097400,130328500,43486573649.6,39842980124,100053895917.4,6239306.6,2869669.4,2540826.4,328843,3643593525.6,1.9,1188500,-828800,-6988069000,"2022-12-16T10:42:00.000Z",1671187320000,2017300,3217800,331683300,12000,52997604800,22885766400,29873835400,238003000
62994100,835865935300,2873077218100,2037211282800,4988983923300,195932800,132938700,43486573649.6,39842980124,100053895917.4,6239306.6,2869669.4,2540826.4,328843,3643593525.6,6.6,835400,-1774800,-23956101200,"2022-12-16T10:44:00.000Z",1671187440000,2610200,3456100,335139400,10500,52331753400,14111811100,38067912300,152030000
62075800,818425292200,2892648840000,2074223547800,5045588449200,197138800,135063000,43486573649.6,39842980124,100053895917.4,6239306.6,2869669.4,2540826.4,328843,3643593525.6,4.8,1206000,-918300,-17440643100,"2022-12-16T10:46:00.000Z",1671187560000,2124300,3333400,338472800,3100,56604525900,19571621900,37012265000,20639000
60600900,797975766300,2915953773100,2117978006800,5113117944300,198441100,137840200,43486573649.6,39842980124,100053895917.4,6239306.6,2869669.4,2540826.4,328843,3643593525.6,5.6,1302300,-1474900,-20449525900,"2022-12-16T10:48:00.000Z",1671187680000,2777200,4110700,342583500,31200,67529495100,23304933100,43754459000,470103000
59127400,770764519200,2932238898000,2161474378800,5173039106200,199469400,140342000,43486573649.6,39842980124,100053895917.4,6239306.6,2869669.4,2540826.4,328843,3643593525.6,7.5,1028300,-1473500,-27211247100,"2022-12-16T10:50:00.000Z",1671187800000,2501800,3542500,346126000,12400,59921161900,16285124900,43496372000,139665000
58257700,758384180700,2951496402700,2193112222000,5224032119100,200674800,142417100,43486573649.6,39842980124,100053895917.4,6239306.6,2869669.4,2540826.4,328843,3643593525.6,3.4,1205400,-869700,-12380338500,"2022-12-16T10:52:00.000Z",1671187920000,2075100,3283200,349409200,2700,50993012900,19257504700,31637843200,97665000
58739100,766991483300,2982602058200,2215610574900,5277850120500,202519400,143780300,43486573649.6,39842980124,100053895917.4,6239306.6,2869669.4,2540826.4,328843,3643593525.6,2.4,1844600,481400,8607302600,"2022-12-16T10:54:00.000Z",1671188040000,1363200,3220600,352629800,12800,53818001400,31105655500,22498352900,213993000
59481700,776332805200,3009598575900,2233265770700,5322814133000,204393400,144911700,43486573649.6,39842980124,100053895917.4,6239306.6,2869669.4,2540826.4,328843,3643593525.6,2.6,1874000,742600,9341321900,"2022-12-16T10:56:00.000Z",1671188160000,1131400,3018900,355648700,13500,44964012500,26996517700,17655195800,312299000
60322800,795724588800,3040596092200,2244871503400,5365555962000,205978600,145655800,43486573649.6,39842980124,100053895917.4,6239306.6,2869669.4,2540826.4,328843,3643593525.6,5.3,1585200,841100,19391783600,"2022-12-16T10:58:00.000Z",1671188280000,744100,2341700,357990400,12400,42741829000,30997516300,11605732700,138580000
60134400,795037956800,3057166475500,2262128518700,5399766503600,206912700,146778300,43486573649.6,39842980124,100053895917.4,6239306.6,2869669.4,2540826.4,328843,3643593525.6,0.2,934100,-188400,-686632000,"2022-12-16T11:00:00.000Z",1671188400000,1122500,2084700,360075100,28100,34210541600,16570383300,17257015300,383143000
59648800,785380733600,3069421841300,2284041107700,5434161168400,207630700,147981900,43486573649.6,39842980124,100053895917.4,6239306.6,2869669.4,2540826.4,328843,3643593525.6,2.7,718000,-485600,-9657223200,"2022-12-16T11:02:00.000Z",1671188520000,1203600,1931100,362006200,9500,34394664800,12255365800,21912589000,226710000
59867200,782638185800,3086803599400,2304165413600,5471691407400,209114700,149247500,43486573649.6,39842980124,100053895917.4,6239306.6,2869669.4,2540826.4,328843,3643593525.6,0.8,1484000,218400,-2742547800,"2022-12-16T11:04:00.000Z",1671188640000,1265600,2752400,364758600,2800,37530239000,17381758100,20124305900,24175000
59429300,783599289800,3112506235600,2328906945800,5522215916800,210265400,150836100,43486573649.6,39842980124,100053895917.4,6239306.6,2869669.4,2540826.4,328843,3643593525.6,0.3,1150700,-437900,961104000,"2022-12-16T11:06:00.000Z",1671188760000,1588600,2743600,367502200,4300,50524509400,25702636200,24741532200,80341000
59063200,776302731000,3128441845100,2352139114100,5561388219000,211321300,152258100,43486573649.6,39842980124,100053895917.4,6239306.6,2869669.4,2540826.4,328843,3643593525.6,2,1055900,-366100,-7296558800,"2022-12-16T11:08:00.000Z",1671188880000,1422000,2478400,369980600,500,39172302200,15935609500,23232168300,4524400
58219000,756872648400,3143303954400,2386431306000,5610597965200,212296000,154077000,43486573649.6,39842980124,100053895917.4,6239306.6,2869669.4,2540826.4,328843,3643593525.6,5.3,974700,-844200,-19430082600,"2022-12-16T11:10:00.000Z",1671189000000,1818900,2799300,372779900,5700,49209746200,14862109300,34292191900,55445000
57018200,738176495000,3157758606500,2419582111500,5658362128800,213078200,156060000,43486573649.6,39842980124,100053895917.4,6239306.6,2869669.4,2540826.4,328843,3643593525.6,5.1,782200,-1200800,-18696153400,"2022-12-16T11:12:00.000Z",1671189120000,1983000,2780600,375560500,15400,47764163600,14454652100,33150805500,158706000
56070300,721795063700,3172219846600,2450424782900,5703703057300,213971600,157901300,43486573649.6,39842980124,100053895917.4,6239306.6,2869669.4,2540826.4,328843,3643593525.6,4.5,893400,-947900,-16381431300,"2022-12-16T11:14:00.000Z",1671189240000,1841300,2736700,378297200,2000,45340928500,14461240100,30842671400,37017000
55214300,716813798800,3186742141600,2469928342800,5737745187200,214721300,159507000,43486573649.6,39842980124,100053895917.4,6239306.6,2869669.4,2540826.4,328843,3643593525.6,1.4,749700,-856000,-4981264900,"2022-12-16T11:16:00.000Z",1671189360000,1605700,2355800,380653000,400,34042129900,14522295000,19503559900,16275000.000000002
52645400,673613355800,3200420614700,2526807258900,5808481206800,215439100,162793700,43486573649.6,39842980124,100053895917.4,6239306.6,2869669.4,2540826.4,328843,3643593525.6,11.9,717800,-2568900,-43200443000,"2022-12-16T11:18:00.000Z",1671189480000,3286700,4018700,384671700,14200,70736019600,13678473100,56878916100,178630400
48811000,623681925500,3217413768800,2593731843300,5892418467400,216337000,167526000,43486573649.6,39842980124,100053895917.4,6239306.6,2869669.4,2540826.4,328843,3643593525.6,13.7,897900,-3834400,-49931430300,"2022-12-16T11:20:00.000Z",1671189600000,4732300,5633800,390305500,3600,83937260600,16993154100,66924584400,19522100
48343300,613194967600,3232301498800,2619106531200,5932942185300,217380300,169037000,43486573649.6,39842980124,100053895917.4,6239306.6,2869669.4,2540826.4,328843,3643593525.6,2.9,1043300,-467700,-10486957900,"2022-12-16T11:22:00.000Z",1671189720000,1511000,2573800,392879300,19500,40523717900,14887730000,25374687900,261300000
47323600,596542758000,3247371519200,2650828761200,5979935895700,218310700,170987100,43486573649.6,39842980124,100053895917.4,6239306.6,2869669.4,2540826.4,328843,3643593525.6,4.6,930400,-1019700,-16652209600,"2022-12-16T11:24:00.000Z",1671189840000,1950100,2890900,395770200,10400,46993710400,15070020400,31722230000,201460000
45684400,570411812500,3264847116800,2694435304300,6041050268400,219373700,173689300,43486573649.6,39842980124,100053895917.4,6239306.6,2869669.4,2540826.4,328843,3643593525.6,7.2,1063000,-1639200,-26130945500,"2022-12-16T11:26:00.000Z",1671189960000,2702200,3767000,399537200,1800,61114372700,17475597600,43606543100,32232000
43400300,543020450200,3281411132200,2738390682000,6101947528500,220294900,176894600,43486573649.6,39842980124,100053895917.4,6239306.6,2869669.4,2540826.4,328843,3643593525.6,7.5,921200,-2284100,-27391362300,"2022-12-16T11:28:00.000Z",1671190080000,3205300,4141300,403678500,14800,60897260100,16564015400,43955377700,377867000
43367500,542526746200,3281468672200,2738941926000,6102556312500,220299600,176932100,43486573649.6,39842980124,100053895917.4,6239306.6,2869669.4,2540826.4,328843,3643593525.6,0.1,4700,-32800,-493704000,"2022-12-16T11:30:00.000Z",1671190200000,37500,42200,403720700,0,608784000,57540000,551244000,0
39375500,475838795600,3327509269300,2851670473700,6264232601800,223499100,184123600,43486573649.6,39842980124,100053895917.4,6239306.6,2869669.4,2540826.4,328843,3643593525.6,18.3,3199500,-3992000,-66687950600,"2022-12-16T13:00:00.000Z",1671195600000,7191500,10630600,414351300,239600,161676289300,46040597100,112728547700,2907144500
38955100,471182517500,3355750695800,2884568178300,6325487320700,225254700,186299600,43486573649.6,39842980124,100053895917.4,6239306.6,2869669.4,2540826.4,328843,3643593525.6,1.3,1755600,-420400,-4656278100,"2022-12-16T13:02:00.000Z",1671195720000,2176000,3933800,418285100,2200,61254718900,28241426500,32897704600,115587800
39602700,477503292100,3399385235600,2921881943500,6407349407800,228149700,188547000,43486573649.6,39842980124,100053895917.4,6239306.6,2869669.4,2540826.4,328843,3643593525.6,1.7,2895000,647600,6320774600,"2022-12-16T13:04:00.000Z",1671195840000,2247400,5205600,423490700,63200,81862087100,43634539800,37313765200,913782100
39211100,468769761400,3431167591700,2962397830300,6479873315700,230359500,191148400,43486573649.6,39842980124,100053895917.4,6239306.6,2869669.4,2540826.4,328843,3643593525.6,2.4,2209800,-391600,-8733530700,"2022-12-16T13:06:00.000Z",1671195960000,2601400,4841700,428332400,30500,72523907900,31782356100,40515886800,225665000
38580200,449439105600,3466136870500,3016697764900,6569289354100,232592500,194012300,43486573649.6,39842980124,100053895917.4,6239306.6,2869669.4,2540826.4,328843,3643593525.6,5.3,2233000,-630900,-19330655800,"2022-12-16T13:08:00.000Z",1671196080000,2863900,5111400,433443800,14500,89416038400,34969278800,54299934600,146825000
38142400,427211740700,3489369243500,3062157502800,6638049568000,234419400,196277000,43486573649.6,39842980124,100053895917.4,6239306.6,2869669.4,2540826.4,328843,3643593525.6,6.1,1826900,-437800,-22227364900,"2022-12-16T13:10:00.000Z",1671196200000,2264700,4102900,437546700,11300,68760213900,23232373000,45459737900,68103000
37959900,413804353000,3521722309100,3107917956100,6716459679500,237127800,199167900,43486573649.6,39842980124,100053895917.4,6239306.6,2869669.4,2540826.4,328843,3643593525.6,3.7,2708400,-182500,-13407387700,"2022-12-16T13:12:00.000Z",1671196320000,2890900,5622700,443169400,23400,78410111500,32353065600,45760453300,296592600
38399100,419658734200,3556240690800,3136581956600,6779828639700,239389000,200989900,43486573649.6,39842980124,100053895917.4,6239306.6,2869669.4,2540826.4,328843,3643593525.6,1.6,2261200,439200,5854381200,"2022-12-16T13:14:00.000Z",1671196440000,1822000,4093600,447263000,10400,63368960200,34518381700,28664000500,186578000
39179200,427520344400,3593664361400,3166144017000,6847067120700,241745500,202566300,43486573649.6,39842980124,100053895917.4,6239306.6,2869669.4,2540826.4,328843,3643593525.6,2.2,2356500,780100,7861610200,"2022-12-16T13:16:00.000Z",1671196560000,1576400,3938000,451201000,5100,67238481000,37423670600,29562060400,252750000
41551900,462701136200,3652563459700,3189862323500,6929855055500,245504600,203952700,43486573649.6,39842980124,100053895917.4,6239306.6,2869669.4,2540826.4,328843,3643593525.6,9.7,3759100,2372700,35180791800,"2022-12-16T13:18:00.000Z",1671196680000,1386400,5158800,456359800,13300,82787934800,58899098300,23718306500,170530000
44162800,493505770000,3709983191300,3216477421300,7014373148900,249730300,205567500,43486573649.6,39842980124,100053895917.4,6239306.6,2869669.4,2540826.4,328843,3643593525.6,8.5,4225700,2610900,30804633800,"2022-12-16T13:20:00.000Z",1671196800000,1614800,5852900,462212700,12400,84518093400,57419731600,26615097800,483264000
45168400,509105339800,3750310997800,3241205658000,7079460046100,252362900,207194500,43486573649.6,39842980124,100053895917.4,6239306.6,2869669.4,2540826.4,328843,3643593525.6,4.3,2632600,1005600,15599569800,"2022-12-16T13:22:00.000Z",1671196920000,1627000,4261400,466474100,1800,65086897200,40327806500,24728236700,30854000
45836200,514813025500,3794072891500,3279259866000,7161398722800,255053100,209216900,43486573649.6,39842980124,100053895917.4,6239306.6,2869669.4,2540826.4,328843,3643593525.6,1.6,2690200,667800,5707685700,"2022-12-16T13:24:00.000Z",1671197040000,2022400,4718100,471192200,5500,81938676700,43761893700,38054208000,122575000
44961500,501335869900,3821481362900,3320145493000,7229742061200,256807200,211845700,43486573649.6,39842980124,100053895917.4,6239306.6,2869669.4,2540826.4,328843,3643593525.6,3.7,1754100,-874700,-13477155600,"2022-12-16T13:26:00.000Z",1671197160000,2628800,4386600,475578800,3700,68343338400,27408471400,40885627000,49240000
42772700,459533208900,3838921163400,3379387954500,7306509163200,258007100,215234400,43486573649.6,39842980124,100053895917.4,6239306.6,2869669.4,2540826.4,328843,3643593525.6,11.5,1199900,-2188800,-41802661000,"2022-12-16T13:28:00.000Z",1671197280000,3388700,4595700,480174500,7100,76767102000,17439800500,59242461500,84840000
38240500,394453645600,3859614306600,3465160661000,7413084658500,259283000,221042500,43486573649.6,39842980124,100053895917.4,6239306.6,2869669.4,2540826.4,328843,3643593525.6,17.9,1275900,-4532200,-65079563300,"2022-12-16T13:30:00.000Z",1671197400000,5808100,7090500,487265000,6500,106575495300,20693143200,85772706500,109645600
33684500,326819531500,3877217139200,3550397607700,7516371158800,260471900,226787400,43486573649.6,39842980124,100053895917.4,6239306.6,2869669.4,2540826.4,328843,3643593525.6,18.6,1188900,-4556000,-67634114100,"2022-12-16T13:32:00.000Z",1671197520000,5744900,6963900,494228900,30100,103286500300,17602832600,85236946700,446721000
31736500,296711781900,3908123651500,3611411869600,7608558218000,262412600,230676100,43486573649.6,39842980124,100053895917.4,6239306.6,2869669.4,2540826.4,328843,3643593525.6,8.3,1940700,-1948000,-30107749600,"2022-12-16T13:34:00.000Z",1671197640000,3888700,5846400,500075300,17000,92187059200,30906512300,61014261900,266285000
31922500,302509637200,3943175450800,3640665813600,7672947781300,264773200,232850700,43486573649.6,39842980124,100053895917.4,6239306.6,2869669.4,2540826.4,328843,3643593525.6,1.6,2360600,186000,5797855300,"2022-12-16T13:36:00.000Z",1671197760000,2174600,4537700,504613000,2500,64389563300,35051799300,29253944000,83820000
32470700,319830593300,3980831979400,3661001386100,7730955587400,266802700,234332000,43486573649.6,39842980124,100053895917.4,6239306.6,2869669.4,2540826.4,328843,3643593525.6,4.8,2029500,548200,17320956100,"2022-12-16T13:38:00.000Z",1671197880000,1481300,3512100,508125100,1300,58007806100,37656528600,20335572500,15705000
31897000,308219785400,4001153838700,3692934053300,7783532664900,268371700,236474700,43486573649.6,39842980124,100053895917.4,6239306.6,2869669.4,2540826.4,328843,3643593525.6,3.2,1569000,-573700,-11610807900,"2022-12-16T13:40:00.000Z",1671198000000,2142700,3719400,511844500,7700,52577077500,20321859300,31932667200,322551000
29981200,277416764400,4023364617900,3745947853500,7858845623500,269828500,239847300,43486573649.6,39842980124,100053895917.4,6239306.6,2869669.4,2540826.4,328843,3643593525.6,8.5,1456800,-1915800,-30803021000,"2022-12-16T13:42:00.000Z",1671198120000,3372600,4832100,516676600,2700,75312958600,22210779200,53013800200,88379200
29392500,268965307700,4043423351100,3774458043400,7907475756600,271139300,241746800,43486573649.6,39842980124,100053895917.4,6239306.6,2869669.4,2540826.4,328843,3643593525.6,2.3,1310800,-588700,-8451456700,"2022-12-16T13:44:00.000Z",1671198240000,1899500,3211100,519887700,800,48630133100,20058733200,28510189900,61210000
29866500,272863692700,4072167356000,3799303663300,7961304284400,273172300,243305800,43486573649.6,39842980124,100053895917.4,6239306.6,2869669.4,2540826.4,328843,3643593525.6,1.1,2033000,474000,3898385000,"2022-12-16T13:46:00.000Z",1671198360000,1559000,3610500,523498200,18500,53828527800,28744004900,24845619900,238903000
30560900,280602656100,4109379566900,3828776910800,8028002382800,275729000,245168100,43486573649.6,39842980124,100053895917.4,6239306.6,2869669.4,2540826.4,328843,3643593525.6,2.1,2556700,694400,7738963400,"2022-12-16T13:48:00.000Z",1671198480000,1862300,4420500,527918700,1500,66698098400,37212210900,29473247500,12640000
32241500,309416755100,4163132795400,3853716040300,8106809218800,278964300,246722800,43486573649.6,39842980124,100053895917.4,6239306.6,2869669.4,2540826.4,328843,3643593525.6,7.9,3235300,1680600,28814099000,"2022-12-16T13:50:00.000Z",1671198600000,1554700,4798700,532717400,8700,78806836000,53753228500,24939129500,114478000
34248200,345712775000,4222118954300,3876406179300,8188705656700,282573700,248325500,43486573649.6,39842980124,100053895917.4,6239306.6,2869669.4,2540826.4,328843,3643593525.6,10,3609400,2006700,36296019900,"2022-12-16T13:52:00.000Z",1671198720000,1602700,5229700,537947100,17600,81896437900,58986158900,22690139000,220140000
36971900,394199018000,4297371917900,3903172899900,8290930890500,286763800,249791900,43486573649.6,39842980124,100053895917.4,6239306.6,2869669.4,2540826.4,328843,3643593525.6,13.3,4190100,2723700,48486243000,"2022-12-16T13:54:00.000Z",1671198840000,1466400,5667100,543614200,10600,102225233800,75252963600,26766720600,205549600
36615200,379636119800,4329235151600,3949599031800,8369537335100,289032700,252417500,43486573649.6,39842980124,100053895917.4,6239306.6,2869669.4,2540826.4,328843,3643593525.6,4,2268900,-356700,-14562898200,"2022-12-16T13:56:00.000Z",1671198960000,2625600,4903600,548517800,9100,78606444600,31863233700,46426131900,317079000
34444300,348585211200,4350222067800,4001636856600,8442881591100,290259200,255814900,43486573649.6,39842980124,100053895917.4,6239306.6,2869669.4,2540826.4,328843,3643593525.6,8.5,1226500,-2170900,-31050908600,"2022-12-16T13:58:00.000Z",1671199080000,3397400,4633400,553151200,9500,73344256000,20986916200,52037824800,319515000
33838200,340200641700,4382174532800,4041973891100,8515696859600,292094300,258256100,43486573649.6,39842980124,100053895917.4,6239306.6,2869669.4,2540826.4,328843,3643593525.6,2.3,1835100,-606100,-8384569500,"2022-12-16T14:00:00.000Z",1671199200000,2441200,4308100,557459300,31800,72815268500,31952465000,40337034500,525769000
33291600,331896373500,4413924219600,4082027846100,8588318393900,293747400,260455800,43486573649.6,39842980124,100053895917.4,6239306.6,2869669.4,2540826.4,328843,3643593525.6,2.3,1653100,-546600,-8304268200,"2022-12-16T14:02:00.000Z",1671199320000,2199700,3887200,561346500,34400,72621534300,31749686800,40053955000,817892500
33655900,341839669300,4453440078300,4111600409000,8657531639500,295992300,262336400,43486573649.6,39842980124,100053895917.4,6239306.6,2869669.4,2540826.4,328843,3643593525.6,2.7,2244900,364300,9943295800,"2022-12-16T14:04:00.000Z",1671199440000,1880600,4137800,565484300,12300,69213245600,39515858700,29572562900,124824000
34774400,373706011500,4505080101700,4131374090200,8729219721100,298904400,264130000,43486573649.6,39842980124,100053895917.4,6239306.6,2869669.4,2540826.4,328843,3643593525.6,8.7,2912100,1118500,31866342200,"2022-12-16T14:06:00.000Z",1671199560000,1793600,4734900,570219200,29200,71688081600,51640023400,19773681200,274377000
38153200,437922085900,4592805519100,4154883433200,8840592467500,303709100,265555900,43486573649.6,39842980124,100053895917.4,6239306.6,2869669.4,2540826.4,328843,3643593525.6,17.6,4804700,3378800,64216074400,"2022-12-16T14:08:00.000Z",1671199680000,1425900,6248700,576467900,18100,111372746400,87725417400,23509343000,137986000
41577400,487904579500,4670089093600,4182184514100,8945410716900,308630500,267053100,43486573649.6,39842980124,100053895917.4,6239306.6,2869669.4,2540826.4,328843,3643593525.6,13.7,4921400,3424200,49982493600,"2022-12-16T14:10:00.000Z",1671199800000,1497200,6436300,582904200,17700,104818249400,77283574500,27301080900,233594000
42869800,506790866200,4740751873100,4233961006900,9068312424200,313139800,270270000,43486573649.6,39842980124,100053895917.4,6239306.6,2869669.4,2540826.4,328843,3643593525.6,5.2,4509300,1292400,18886286700,"2022-12-16T14:12:00.000Z",1671199920000,3216900,7764200,590668400,38000,122901707300,70662779500,51776492800,462435000
43189800,511654784000,4784359313000,4272704529000,9150782773200,315477600,272287800,43486573649.6,39842980124,100053895917.4,6239306.6,2869669.4,2540826.4,328843,3643593525.6,1.3,2337800,320000,4863917800,"2022-12-16T14:14:00.000Z",1671200040000,2017800,4360200,595028600,4600,82470349000,43607439900,38743522100,119387000
43038700,499842244800,4830387959800,4330545715000,9254936807000,318135000,275096300,43486573649.6,39842980124,100053895917.4,6239306.6,2869669.4,2540826.4,328843,3643593525.6,3.2,2657400,-151100,-11812539200,"2022-12-16T14:16:00.000Z",1671200160000,2808500,5476900,600505500,11000,104154033800,46028646800,57841186000,284201000
40933000,478570520700,4873798920300,4395228399600,9363127923600,320427600,279494600,43486573649.6,39842980124,100053895917.4,6239306.6,2869669.4,2540826.4,328843,3643593525.6,5.8,2292600,-2105700,-21271724100,"2022-12-16T14:18:00.000Z",1671200280000,4398300,6706000,607211500,15100,108191116600,43410960500,64682684600,97471500
36052000,411523054000,4912494462700,4500971408700,9508507493900,322576100,286524100,43486573649.6,39842980124,100053895917.4,6239306.6,2869669.4,2540826.4,328843,3643593525.6,18.4,2148500,-4881000,-67047466700,"2022-12-16T14:20:00.000Z",1671200400000,7029500,9228000,616439500,50000,145379570300,38695542400,105743009100,941018800
32829300,355278113400,4947873327300,4592595213900,9636518537700,324880800,292051500,43486573649.6,39842980124,100053895917.4,6239306.6,2869669.4,2540826.4,328843,3643593525.6,15.4,2304700,-3222700,-56244940600,"2022-12-16T14:22:00.000Z",1671200520000,5527400,7889300,624328800,57200,128011043800,35378864600,91623805200,1008374000
33378500,358375728600,5007612076800,4649236348200,9753706501500,328615000,295236500,43486573649.6,39842980124,100053895917.4,6239306.6,2869669.4,2540826.4,328843,3643593525.6,0.9,3734200,549200,3097615200,"2022-12-16T14:24:00.000Z",1671200640000,3185000,6958200,631287000,39000,117187963800,59738749500,56641134300,808080000
33192700,357491993500,5066013897400,4708521903900,9873127838800,332198000,299005300,43486573649.6,39842980124,100053895917.4,6239306.6,2869669.4,2540826.4,328843,3643593525.6,0.2,3583000,-185800,-883735100,"2022-12-16T14:26:00.000Z",1671200760000,3768800,7463800,638750800,112000,119421337300,58401820600,59285555700,1733960999.9999998
31790700,324398096700,5119532684700,4795134588000,10013949166000,336379000,304588300,43486573649.6,39842980124,100053895917.4,6239306.6,2869669.4,2540826.4,328843,3643593525.6,9.1,4181000,-1402000,-33093896800,"2022-12-16T14:28:00.000Z",1671200880000,5583000,9804200,648555000,40200,140821327200,53518787300,86612684100,689855800
31792600,324285290300,5119654593300,4795369303000,10014305789600,336391800,304599200,43486573649.6,39842980124,100053895917.4,6239306.6,2869669.4,2540826.4,328843,3643593525.6,0,12800,1900,-112806400,"2022-12-16T14:30:00.000Z",1671201000000,10900,23700,648578700,0,356623600,121908600,234715000,0
31797600,324335790300,5119705093300,4795369303000,10014356289600,336396800,304599200,43486573649.6,39842980124,100053895917.4,6239306.6,2869669.4,2540826.4,328843,3643593525.6,0,5000,5000,50500000,"2022-12-16T14:36:00.000Z",1671201360000,0,5000,648583700,0,50500000,50500000,0,0
31798400,324343870300,5119713173300,4795369303000,10014364369600,336397600,304599200,43486573649.6,39842980124,100053895917.4,6239306.6,2869669.4,2540826.4,328843,3643593525.6,0,800,800,8080000,"2022-12-16T14:38:00.000Z",1671201480000,0,800,648584500,0,8080000,8080000,0,0
31798600,324345900300,5119715203300,4795369303000,10014366399600,336397800,304599200,43486573649.6,39842980124,100053895917.4,6239306.6,2869669.4,2540826.4,328843,3643593525.6,0,200,200,2030000,"2022-12-16T14:42:00.000Z",1671201720000,0,200,648584700,0,2030000,2030000,0,0
39818500,441157066600,5261875411600,4820718345000,12106239156000,347230000,307411500,43486573649.6,39842980124,100053895917.4,6239306.6,2869669.4,2540826.4,328843,3643593525.6,32.1,10832200,8019900,116811166300,"2022-12-16T14:44:00.000Z",1671201840000,2812300,106342900,754927600,92698400,2091872756400,142160208300,25349042000,1924363506100
39818000,441152016600,5261875411600,4820723395000,12106244206000,347230000,307412000,43486573649.6,39842980124,100053895917.4,6239306.6,2869669.4,2540826.4,328843,3643593525.6,0,0,-500,-5050000,"2022-12-16T14:48:00.000Z",1671202080000,500,500,754928100,0,5050000,0,5050000,0
39790000,440874816600,5261875411600,4821000595000,12106521406000,347230000,307440000,43486573649.6,39842980124,100053895917.4,6239306.6,2869669.4,2540826.4,328843,3643593525.6,0.1,0,-28000,-277200000,"2022-12-16T14:50:00.000Z",1671202200000,28000,28000,754956100,0,277200000,0,277200000,0
