"abu","acum_busd","acum_busd_val","acum_val_bu","acum_val_sd","acum_val","avg_val_bu","avg_val_sd","rbusd","asd","auk","bs","bu","bu-sd","bu-sd_val","c","date","datetime","h","l","o","pbu","psd","puk","rbu","rsd","ruk","sb","sd","sum_vol","total_vol","uk","val","val_bu","val_sd","val_uk"
35729.8,1400,29960000,36380000,6420000,1093540000,782623728.1,435427280.7,0.1,19856.1,3255.3,5.7,1700,1400,29960000,21400,"2023-02-16T09:14:00.000Z",1676538840000,21400,21400,21400,3.3,0.6,96.1,0,0,15.1,0.2,300,51100,51100,49100,1093540000,36380000,6420000,1050740000
35729.8,-12300,-263135000,117755000,380890000,1549385000,782623728.1,435427280.7,-0.8,19856.1,3255.3,0.2,3800,-13700,-293095000,21400,"2023-02-16T09:16:00.000Z",1676538960000,21450,21300,21400,17.8,82.2,0,0.1,0.9,,4.6,17500,21300,72400,,455845000,81375000,374470000,
35729.8,16600,356745000,750475000,393730000,2194945000,782623728.1,435427280.7,1.8,19856.1,3255.3,49.2,29500,28900,619880000,21450,"2023-02-16T09:18:00.000Z",1676539080000,21450,21400,21400,98,2,0,0.8,0,,0,600,30100,102500,,645560000,632720000,12840000,
35729.8,-17600,-374975000,819115000,1194090000,3063945000,782623728.1,435427280.7,-2.1,19856.1,3255.3,0.1,3200,-34200,-731720000,21400,"2023-02-16T09:20:00.000Z",1676539200000,21450,21400,21450,7.9,92.1,0,0.1,1.9,,11.7,37400,40600,143100,,869000000,68640000,800360000,
35729.8,-13000,-276480000,941095000,1217575000,3209410000,782623728.1,435427280.7,0.3,19856.1,3255.3,5.2,5700,4600,98495000,21350,"2023-02-16T09:22:00.000Z",1676539320000,21400,21350,21400,83.8,16.2,0,0.2,0.1,,0.2,1100,6800,149900,,145465000,121980000,23485000,
35729.8,-6500,-137130000,1399195000,1536325000,3986260000,782623728.1,435427280.7,0.4,19856.1,3255.3,1.4,21400,6500,139350000,21400,"2023-02-16T09:24:00.000Z",1676539440000,21450,21350,21350,59,41,0,0.6,0.8,,0.7,14900,36300,186200,,776850000,458100000,318750000,
35729.8,-12300,-260365000,1551125000,1811490000,4413355000,782623728.1,435427280.7,-0.4,19856.1,3255.3,0.6,7100,-5800,-123235000,21300,"2023-02-16T09:26:00.000Z",1676539560000,21400,21300,21400,35.5,64.5,0,0.2,0.6,,1.8,12900,20000,206200,,427095000,151930000,275165000,
35729.8,-6000,-126425000,2149395000,2275820000,5475955000,782623728.1,435427280.7,0.4,19856.1,3255.3,1.3,28100,6300,133940000,21250,"2023-02-16T09:28:00.000Z",1676539680000,21300,21200,21300,56.3,43.7,0,0.8,1.1,,0.8,21800,49900,256100,,1062600000,598270000,464330000,
35729.8,-500,-8785000,2414010000,2422795000,5887545000,782623728.1,435427280.7,0.3,19856.1,3255.3,1.8,12400,5500,117640000,21350,"2023-02-16T09:30:00.000Z",1676539800000,21350,21250,21250,64.2,35.8,0,0.3,0.3,,0.6,6900,19300,275400,,411590000,264615000,146975000,
35729.8,3100,68475000,2585210000,2516735000,6152685000,782623728.1,435427280.7,0.2,19856.1,3255.3,1.8,8000,3600,77260000,21350,"2023-02-16T09:32:00.000Z",1676539920000,21400,21350,21400,64.5,35.5,0,0.2,0.2,,0.6,4400,12400,287800,,265140000,171200000,93940000,
35729.8,80100,1716430000,4335800000,2619370000,8005910000,782623728.1,435427280.7,4.7,19856.1,3255.3,17,81800,77000,1647955000,21450,"2023-02-16T09:34:00.000Z",1676540040000,21450,21350,21400,94.5,5.5,0,2.3,0.2,,0.1,4800,86600,374400,,1853225000,1750590000,102635000,
35729.8,220600,4732615000,7607240000,2874625000,11532605000,782623728.1,435427280.7,8.7,19856.1,3255.3,12.8,152400,140500,3016185000,21500,"2023-02-16T09:36:00.000Z",1676540160000,21500,21450,21450,92.8,7.2,0,4.3,0.6,,0.1,11900,164300,538700,,3526695000,3271440000,255255000,
35729.8,490900,10550575000,13831385000,3280810000,18162935000,782623728.1,435427280.7,16.8,19856.1,3255.3,15.3,289200,270300,5817960000,21650,"2023-02-16T09:38:00.000Z",1676540280000,21650,21450,21450,93.9,6.1,0,8.1,1,,0.1,18900,308100,846800,,6630330000,6224145000,406185000,
35729.8,633300,13648005000,17983555000,4335550000,23369845000,782623728.1,435427280.7,8.9,19856.1,3255.3,3.9,190900,142400,3097430000,21850,"2023-02-16T09:40:00.000Z",1676540400000,21850,21600,21600,79.7,20.3,0,5.3,2.4,,0.3,48500,239400,1086200,,5206910000,4152170000,1054740000,
35729.8,738500,15950645000,20591890000,4641245000,26283875000,782623728.1,435427280.7,6.6,19856.1,3255.3,8.5,119200,105200,2302640000,21900,"2023-02-16T09:42:00.000Z",1676540520000,21900,21800,21850,89.5,10.5,0,3.3,0.7,,0.1,14000,133200,1219400,,2914030000,2608335000,305695000,
35729.8,634100,13672590000,21382685000,7710095000,30143520000,782623728.1,435427280.7,-6.6,19856.1,3255.3,0.3,36300,-104400,-2278055000,21750,"2023-02-16T09:44:00.000Z",1676540640000,21900,21750,21900,20.5,79.5,0,1,7.1,,3.9,140700,177000,1396400,,3859645000,790795000,3068850000,
35729.8,617600,13314565000,21862035000,8547470000,31460245000,782623728.1,435427280.7,-1,19856.1,3255.3,0.6,22000,-16500,-358025000,21750,"2023-02-16T09:46:00.000Z",1676540760000,21800,21750,21750,36.4,63.6,0,0.6,1.9,,1.8,38500,60500,1456900,,1316725000,479350000,837375000,
35729.8,612300,13200170000,22273985000,9073815000,32398540000,782623728.1,435427280.7,-0.3,19856.1,3255.3,0.8,18900,-5300,-114395000,21750,"2023-02-16T09:48:00.000Z",1676540880000,21800,21700,21750,43.9,56.1,0,0.5,1.2,,1.3,24200,43100,1500000,,938295000,411950000,526345000,
35729.8,632500,13639770000,22822085000,9182315000,33055140000,782623728.1,435427280.7,1.3,19856.1,3255.3,5,25200,20200,439600000,21750,"2023-02-16T09:50:00.000Z",1676541000000,21750,21700,21750,83.4,16.6,0,0.7,0.3,,0.2,5000,30200,1530200,,656600000,548100000,108500000,
35729.8,629100,13566335000,22972160000,9405825000,33428725000,782623728.1,435427280.7,-0.2,19856.1,3255.3,0.7,6900,-3400,-73435000,21750,"2023-02-16T09:52:00.000Z",1676541120000,21750,21700,21750,40.1,59.9,0,0.2,0.5,,1.5,10300,17200,1547400,,373585000,150075000,223510000,
35729.8,667100,14394555000,24388585000,9994030000,35433355000,782623728.1,435427280.7,2.4,19856.1,3255.3,2.4,65100,38000,828220000,21750,"2023-02-16T09:54:00.000Z",1676541240000,21800,21700,21700,70.6,29.4,0,1.8,1.4,,0.4,27100,92200,1639600,,2004630000,1416425000,588205000,
35729.8,1167800,25354660000,35888665000,10534005000,47473410000,782623728.1,435427280.7,31.6,19856.1,3255.3,21.3,525400,500700,10960105000,21950,"2023-02-16T09:56:00.000Z",1676541360000,22000,21750,21750,95.5,4.5,0,14.7,1.2,,0,24700,550100,2189700,,12040055000,11500080000,539975000,
35729.8,1705700,37200105000,48289145000,11089040000,60428925000,782623728.1,435427280.7,34.1,19856.1,3255.3,22.3,563100,537900,11845445000,22100,"2023-02-16T09:58:00.000Z",1676541480000,22150,21950,21950,95.7,4.3,0,15.8,1.3,,0,25200,588300,2778000,,12955515000,12400480000,555035000,
35729.8,1888500,41268110000,53127790000,11859680000,66038210000,782623728.1,435427280.7,11.7,19856.1,3255.3,6.3,217500,182800,4068005000,22250,"2023-02-16T10:00:00.000Z",1676541600000,22300,22150,22150,86.2,13.8,0,6.1,1.7,,0.2,34700,252200,3030200,,5609285000,4838645000,770640000,
35729.8,1873500,40937615000,53982360000,13044745000,68077845000,782623728.1,435427280.7,-1,19856.1,3255.3,0.7,38400,-15000,-330495000,22150,"2023-02-16T10:02:00.000Z",1676541720000,22300,22100,22250,41.8,58.2,0,1.1,2.7,,1.4,53400,91800,3122000,,2039635000,854570000,1185065000,
35729.8,1925400,42090285000,55641360000,13551075000,70243175000,782623728.1,435427280.7,3.3,19856.1,3255.3,3.3,74800,51900,1152670000,22150,"2023-02-16T10:04:00.000Z",1676541840000,22200,22100,22150,76.6,23.4,0,2.1,1.2,,0.3,22900,97700,3219700,,2165330000,1659000000,506330000,
35729.8,1909400,41735595000,56258725000,14523130000,71832595000,782623728.1,435427280.7,-1,19856.1,3255.3,0.6,27800,-16000,-354690000,22200,"2023-02-16T10:06:00.000Z",1676541960000,22250,22150,22200,38.8,61.2,0,0.8,2.2,,1.6,43800,71600,3291300,,1589420000,617365000,972055000,
35729.8,1983500,43384535000,58134135000,14749600000,73934475000,782623728.1,435427280.7,4.7,19856.1,3255.3,8.3,84300,74100,1648940000,22250,"2023-02-16T10:08:00.000Z",1676542080000,22250,22150,22200,89.2,10.8,0,2.4,0.5,,0.1,10200,94500,3385800,,2101880000,1875410000,226470000,
35729.8,1966800,43013335000,58287890000,15274555000,74613185000,782623728.1,435427280.7,-1.1,19856.1,3255.3,0.3,6900,-16700,-371200000,22200,"2023-02-16T10:10:00.000Z",1676542200000,22300,22200,22250,22.6,77.4,0,0.2,1.2,,3.4,23600,30500,3416300,,678710000,153755000,524955000,
35729.8,1980500,43318270000,58641665000,15323395000,75015800000,782623728.1,435427280.7,0.9,19856.1,3255.3,7.2,15900,13700,304935000,22200,"2023-02-16T10:12:00.000Z",1676542320000,22250,22200,22250,87.8,12.2,0,0.4,0.1,,0.1,2200,18100,3434400,,402615000,353775000,48840000,
35729.8,1998300,43714700000,59206815000,15492115000,75749670000,782623728.1,435427280.7,1.1,19856.1,3255.3,3.3,25400,17800,396430000,22250,"2023-02-16T10:14:00.000Z",1676542440000,22250,22200,22250,77,23,0,0.7,0.4,,0.3,7600,33000,3467400,,733870000,565150000,168720000,
35729.8,1915100,41867875000,59302490000,17434615000,77787845000,782623728.1,435427280.7,-5.3,19856.1,3255.3,0,4300,-83200,-1846825000,22200,"2023-02-16T10:16:00.000Z",1676542560000,22250,22200,22200,4.7,95.3,0,0.1,4.4,,20.3,87500,91800,3559200,,2038175000,95675000,1942500000,
35729.8,1875900,41000275000,59770910000,18770635000,79592285000,782623728.1,435427280.7,-2.5,19856.1,3255.3,0.3,21100,-39200,-867600000,22200,"2023-02-16T10:18:00.000Z",1676542680000,22200,22150,22200,25.9,74.1,0,0.6,3,,2.9,60300,81400,3640600,,1804440000,468420000,1336020000,
35729.8,1865300,40765750000,60087665000,19321915000,80460320000,782623728.1,435427280.7,-0.7,19856.1,3255.3,0.6,14300,-10600,-234525000,22150,"2023-02-16T10:20:00.000Z",1676542800000,22200,22100,22150,36.5,63.5,0,0.4,1.3,,1.7,24900,39200,3679800,,868035000,316755000,551280000,
35729.8,1871200,40896510000,60477510000,19581000000,81109250000,782623728.1,435427280.7,0.4,19856.1,3255.3,1.5,17600,5900,130760000,22150,"2023-02-16T10:22:00.000Z",1676542920000,22200,22100,22100,60.1,39.9,0,0.5,0.6,,0.7,11700,29300,3709100,,648930000,389845000,259085000,
35729.8,1850400,40436915000,60515165000,20078250000,81644155000,782623728.1,435427280.7,-1.3,19856.1,3255.3,0.1,1700,-20800,-459595000,22100,"2023-02-16T10:24:00.000Z",1676543040000,22150,22100,22150,7,93,0,0,1.1,,13.2,22500,24200,3733300,,534905000,37655000,497250000,
35729.8,1794300,39197715000,60628075000,21430360000,83109175000,782623728.1,435427280.7,-3.6,19856.1,3255.3,0.1,5100,-56100,-1239200000,22100,"2023-02-16T10:26:00.000Z",1676543160000,22150,22050,22100,7.7,92.3,0,0.1,3.1,,12,61200,66300,3799600,,1465020000,112910000,1352110000,
35729.8,1789800,39098580000,60667855000,21569275000,83287870000,782623728.1,435427280.7,-0.3,19856.1,3255.3,0.3,1800,-4500,-99135000,22050,"2023-02-16T10:28:00.000Z",1676543280000,22100,22050,22050,22.2,77.8,0,0.1,0.3,,3.5,6300,8100,3807700,,178695000,39780000,138915000,
35729.8,1787400,39045780000,60720895000,21675115000,83446750000,782623728.1,435427280.7,-0.2,19856.1,3255.3,0.5,2400,-2400,-52800000,22050,"2023-02-16T10:30:00.000Z",1676543400000,22100,22050,22050,33.3,66.7,0,0.1,0.2,,2,4800,7200,3814900,,158880000,53040000,105840000,
35729.8,1788800,39077080000,60910955000,21833875000,83795570000,782623728.1,435427280.7,0.1,19856.1,3255.3,1.2,8600,1400,31300000,22050,"2023-02-16T10:32:00.000Z",1676543520000,22100,22050,22050,54.4,45.6,0,0.2,0.4,,0.8,7200,15800,3830700,,348820000,190060000,158760000,
35729.8,1793400,39179790000,61476715000,22296925000,84824380000,782623728.1,435427280.7,0.3,19856.1,3255.3,1.2,25600,4600,102710000,22100,"2023-02-16T10:34:00.000Z",1676543640000,22100,22050,22050,54.9,45.1,0,0.7,1.1,,0.8,21000,46600,3877300,,1028810000,565760000,463050000,
35729.8,1793900,39191105000,61604895000,22413790000,85069425000,782623728.1,435427280.7,0,19856.1,3255.3,1.1,5800,500,11315000,22050,"2023-02-16T10:36:00.000Z",1676543760000,22100,22050,22100,52.3,47.7,0,0.2,0.3,,0.9,5300,11100,3888400,,245045000,128180000,116865000,
35729.8,1753100,38291995000,62086115000,23794120000,86930975000,782623728.1,435427280.7,-2.6,19856.1,3255.3,0.3,21800,-40800,-899110000,22050,"2023-02-16T10:38:00.000Z",1676543880000,22100,22050,22100,25.8,74.2,0,0.6,3.2,,2.9,62600,84400,3972800,,1861550000,481220000,1380330000,
35729.8,1749100,38204030000,62101550000,23897520000,87049810000,782623728.1,435427280.7,-0.3,19856.1,3255.3,0.1,700,-4000,-87965000,22000,"2023-02-16T10:40:00.000Z",1676544000000,22050,22000,22050,13,87,0,0,0.2,,6.7,4700,5400,3978200,,118835000,15435000,103400000,
35729.8,1683500,36760835000,62103755000,25342920000,88497415000,782623728.1,435427280.7,-4.2,19856.1,3255.3,0,100,-65600,-1443195000,22000,"2023-02-16T10:42:00.000Z",1676544120000,22050,22000,22000,0.2,99.8,0,0,3.3,,657,65700,65800,4044000,,1447605000,2205000,1445400000,
35729.8,1672100,36510120000,62141240000,25631120000,88823100000,782623728.1,435427280.7,-0.7,19856.1,3255.3,0.1,1700,-11400,-250715000,22050,"2023-02-16T10:44:00.000Z",1676544240000,22050,22000,22000,11.5,88.5,0,0,0.7,,7.7,13100,14800,4058800,,325685000,37485000,288200000,
35729.8,1666200,36380955000,62421275000,26040320000,89512335000,782623728.1,435427280.7,-0.4,19856.1,3255.3,0.7,12700,-5900,-129165000,22000,"2023-02-16T10:46:00.000Z",1676544360000,22050,22000,22000,40.6,59.4,0,0.4,0.9,,1.5,18600,31300,4090100,,689235000,280035000,409200000,
35729.8,1658900,36220455000,62465375000,26244920000,89761035000,782623728.1,435427280.7,-0.5,19856.1,3255.3,0.2,2000,-7300,-160500000,22000,"2023-02-16T10:48:00.000Z",1676544480000,22050,22000,22000,17.7,82.3,0,0.1,0.5,,4.7,9300,11300,4101400,,248700000,44100000,204600000,
35729.8,1592200,34754080000,62917400000,28163320000,92131460000,782623728.1,435427280.7,-4.2,19856.1,3255.3,0.2,20500,-66700,-1466375000,22000,"2023-02-16T10:50:00.000Z",1676544600000,22050,22000,22000,19,81,0,0.6,4.4,,4.3,87200,107700,4209100,,2370425000,452025000,1918400000,
35729.8,1548300,33788290000,63031810000,29243520000,93326070000,782623728.1,435427280.7,-2.8,19856.1,3255.3,0.1,5200,-43900,-965790000,22000,"2023-02-16T10:52:00.000Z",1676544720000,22050,22000,22000,9.6,90.4,0,0.1,2.5,,9.4,49100,54300,4263400,,1194610000,114410000,1080200000,
35729.8,1546900,33757615000,63056010000,29298395000,93405145000,782623728.1,435427280.7,-0.1,19856.1,3255.3,0.4,1100,-1400,-30675000,21950,"2023-02-16T10:54:00.000Z",1676544840000,22000,21950,22000,30.6,69.4,0,0,0.1,,2.3,2500,3600,4267000,,79075000,24200000,54875000,
35729.8,1512700,33006925000,63170150000,30163225000,94384115000,782623728.1,435427280.7,-2.2,19856.1,3255.3,0.1,5200,-34200,-750690000,21950,"2023-02-16T10:56:00.000Z",1676544960000,21950,21950,21950,11.7,88.3,0,0.1,2,,7.6,39400,44600,4311600,,978970000,114140000,864830000,
35729.8,1531100,33410805000,63574030000,30163225000,94787995000,782623728.1,435427280.7,1.2,19856.1,3255.3,Infinity,18400,18400,403880000,21950,"2023-02-16T10:58:00.000Z",1676545080000,21950,21950,21950,100,0,0,0.5,,,0,,18400,4330000,,403880000,403880000,,
35729.8,1560900,34064925000,64228150000,30163225000,95442115000,782623728.1,435427280.7,1.9,19856.1,3255.3,Infinity,29800,29800,654120000,22000,"2023-02-16T11:00:00.000Z",1676545200000,22000,21950,21950,100,0,0,0.8,,,0,,29800,4359800,,654120000,654120000,,
35729.8,1556600,33970730000,64311750000,30341020000,95703510000,782623728.1,435427280.7,-0.3,19856.1,3255.3,0.5,3800,-4300,-94195000,21950,"2023-02-16T11:02:00.000Z",1676545320000,22000,21950,22000,31.9,68.1,0,0.1,0.4,,2.1,8100,11900,4371700,,261395000,83600000,177795000,
35729.8,1552100,33871960000,64313950000,30441990000,95806680000,782623728.1,435427280.7,-0.3,19856.1,3255.3,0,100,-4500,-98770000,21950,"2023-02-16T11:04:00.000Z",1676545440000,22000,21950,22000,2.1,97.9,0,0,0.2,,46,4600,4700,4376400,,103170000,2200000,100970000,
35729.8,1555500,33946990000,64489950000,30542960000,96083650000,782623728.1,435427280.7,0.2,19856.1,3255.3,1.7,8000,3400,75030000,22000,"2023-02-16T11:06:00.000Z",1676545560000,22000,21950,22000,63.5,36.5,0,0.2,0.2,,0.6,4600,12600,4389000,,276970000,176000000,100970000,
35729.8,1554100,33916325000,64518550000,30602225000,96171515000,782623728.1,435427280.7,-0.1,19856.1,3255.3,0.5,1300,-1400,-30665000,22000,"2023-02-16T11:08:00.000Z",1676545680000,22000,21950,22000,32.5,67.5,0,0,0.1,,2.1,2700,4000,4393000,,87865000,28600000,59265000,
35729.8,1554100,33916350000,64529550000,30613200000,96193490000,782623728.1,435427280.7,0,19856.1,3255.3,1,500,0,25000,21950,"2023-02-16T11:10:00.000Z",1676545800000,22000,21950,22000,50,50,0,0,0,,1,500,1000,4394000,,21975000,11000000,10975000,
35729.8,1555200,33940775000,64652750000,30711975000,96415465000,782623728.1,435427280.7,0.1,19856.1,3255.3,1.2,5600,1100,24425000,22000,"2023-02-16T11:12:00.000Z",1676545920000,22000,21950,21950,55.4,44.6,0,0.2,0.2,,0.8,4500,10100,4404100,,221975000,123200000,98775000,
35729.8,1552800,33888140000,64672550000,30784410000,96507700000,782623728.1,435427280.7,-0.2,19856.1,3255.3,0.3,900,-2400,-52635000,21950,"2023-02-16T11:14:00.000Z",1676546040000,22000,21950,21950,21.4,78.6,0,0,0.2,,3.7,3300,4200,4408300,,92235000,19800000,72435000,
35729.8,1542300,33657665000,64672550000,31014885000,96738175000,782623728.1,435427280.7,-0.7,19856.1,3255.3,0,,-10500,-230475000,21950,"2023-02-16T11:16:00.000Z",1676546160000,21950,21950,21950,0,100,0,,0.5,,Infinity,10500,10500,4418800,,230475000,,230475000,
35729.8,1528900,33363535000,65034725000,31671190000,97756655000,782623728.1,435427280.7,-0.8,19856.1,3255.3,0.6,16500,-13400,-294130000,21950,"2023-02-16T11:18:00.000Z",1676546280000,21950,21950,21950,35.6,64.4,0,0.5,1.5,,1.8,29900,46400,4465200,,1018480000,362175000,656305000,
35729.8,1529600,33378900000,65050090000,31671190000,97772020000,782623728.1,435427280.7,0,19856.1,3255.3,Infinity,700,700,15365000,21950,"2023-02-16T11:20:00.000Z",1676546400000,21950,21950,21950,100,0,0,0,,,0,,700,4465900,,15365000,15365000,,
35729.8,1531600,33422800000,65093990000,31671190000,97815920000,782623728.1,435427280.7,0.1,19856.1,3255.3,Infinity,2000,2000,43900000,21950,"2023-02-16T11:22:00.000Z",1676546520000,21950,21950,21950,100,0,0,0.1,,,0,,2000,4467900,,43900000,43900000,,
35729.8,1536900,33539185000,65232275000,31693090000,97976105000,782623728.1,435427280.7,0.3,19856.1,3255.3,6.3,6300,5300,116385000,21900,"2023-02-16T11:24:00.000Z",1676546640000,21950,21900,21950,86.3,13.7,0,0.2,0.1,,0.2,1000,7300,4475200,,160185000,138285000,21900000,
35729.8,1524000,33256675000,65232275000,31975600000,98258615000,782623728.1,435427280.7,-0.8,19856.1,3255.3,0,,-12900,-282510000,21900,"2023-02-16T11:26:00.000Z",1676546760000,21900,21900,21900,0,100,0,,0.6,,Infinity,12900,12900,4488100,,282510000,,282510000,
35729.8,1512600,33007095000,65267395000,32260300000,98578435000,782623728.1,435427280.7,-0.7,19856.1,3255.3,0.1,1600,-11400,-249580000,21950,"2023-02-16T11:28:00.000Z",1676546880000,21950,21900,21900,11,89,0,0,0.7,,8.1,13000,14600,4502700,,319820000,35120000,284700000,
35729.8,1508000,32906950000,65528600000,32621650000,99200990000,782623728.1,435427280.7,-0.3,19856.1,3255.3,0.7,11900,-4600,-100145000,21950,"2023-02-16T13:00:00.000Z",1676552400000,21950,21900,21950,41.9,58.1,0,0.3,0.8,,1.4,16500,28400,4531100,,622555000,261205000,361350000,
35729.8,1474500,32173365000,65557135000,33383770000,99991645000,782623728.1,435427280.7,-2.1,19856.1,3255.3,0,1300,-33500,-733585000,21900,"2023-02-16T13:02:00.000Z",1676552520000,21950,21900,21900,3.6,96.4,0,0,1.8,,26.8,34800,36100,4567200,,790655000,28535000,762120000,
35729.8,1449100,31617410000,65691030000,34073620000,100815390000,782623728.1,435427280.7,-1.6,19856.1,3255.3,0.2,6100,-25400,-555955000,21900,"2023-02-16T13:04:00.000Z",1676552640000,21950,21900,21900,16.2,83.8,0,0.2,1.6,,5.2,31500,37600,4604800,,823745000,133895000,689850000,
35729.8,1348500,29416575000,65914410000,36497835000,103462985000,782623728.1,435427280.7,-6.3,19856.1,3255.3,0.1,10200,-100600,-2200835000,21850,"2023-02-16T13:06:00.000Z",1676552760000,21900,21850,21900,8.4,91.6,0,0.3,5.6,,10.9,110800,121000,4725800,,2647595000,223380000,2424215000,
35729.8,1352300,29499860000,66026100000,36526240000,103603080000,782623728.1,435427280.7,0.2,19856.1,3255.3,3.9,5100,3800,83285000,21900,"2023-02-16T13:08:00.000Z",1676552880000,21900,21850,21850,79.7,20.3,0,0.1,0.1,,0.3,1300,6400,4732200,,140095000,111690000,28405000,
35729.8,1341400,29261715000,66034860000,36773145000,103858745000,782623728.1,435427280.7,-0.7,19856.1,3255.3,0,400,-10900,-238145000,21850,"2023-02-16T13:10:00.000Z",1676553000000,21900,21850,21900,3.4,96.6,0,0,0.6,,28.3,11300,11700,4743900,,255665000,8760000,246905000,
35729.8,1319600,28785485000,66078660000,37293175000,104422575000,782623728.1,435427280.7,-1.4,19856.1,3255.3,0.1,2000,-21800,-476230000,21850,"2023-02-16T13:12:00.000Z",1676553120000,21900,21850,21850,7.8,92.2,0,0.1,1.2,,11.9,23800,25800,4769700,,563830000,43800000,520030000,
35729.8,1304500,28455815000,66216580000,37760765000,105028085000,782623728.1,435427280.7,-0.9,19856.1,3255.3,0.3,6300,-15100,-329670000,21850,"2023-02-16T13:14:00.000Z",1676553240000,21900,21850,21850,22.7,77.3,0,0.2,1.1,,3.4,21400,27700,4797400,,605510000,137920000,467590000,
35729.8,1326300,28932155000,66697280000,37765125000,105513145000,782623728.1,435427280.7,1.4,19856.1,3255.3,110,22000,21800,476340000,21800,"2023-02-16T13:16:00.000Z",1676553360000,21850,21800,21850,99.1,0.9,0,0.6,0,,0,200,22200,4819600,,485060000,480700000,4360000,
35729.8,1352400,29502570000,67324375000,37821805000,106196920000,782623728.1,435427280.7,1.6,19856.1,3255.3,11,28700,26100,570415000,21850,"2023-02-16T13:18:00.000Z",1676553480000,21850,21800,21850,91.7,8.3,0,0.8,0.1,,0.1,2600,31300,4850900,,683775000,627095000,56680000,
35729.8,1365800,29795415000,67641205000,37845790000,106537735000,782623728.1,435427280.7,0.8,19856.1,3255.3,13.2,14500,13400,292845000,21900,"2023-02-16T13:20:00.000Z",1676553600000,21900,21800,21800,92.9,7.1,0,0.4,0.1,,0.1,1100,15600,4866500,,340815000,316830000,23985000,
35729.8,1317800,28746625000,67645585000,38898960000,107595285000,782623728.1,435427280.7,-3,19856.1,3255.3,0,200,-48000,-1048790000,21850,"2023-02-16T13:22:00.000Z",1676553720000,21900,21850,21850,0.4,99.6,0,0,2.4,,241,48200,48400,4914900,,1057550000,4380000,1053170000,
35729.8,1304500,28456125000,67691575000,39235450000,107977765000,782623728.1,435427280.7,-0.8,19856.1,3255.3,0.1,2100,-13300,-290500000,21900,"2023-02-16T13:24:00.000Z",1676553840000,21900,21850,21850,12,88,0,0.1,0.8,,7.3,15400,17500,4932400,,382480000,45990000,336490000,
35729.8,1411900,30811030000,70221280000,39410250000,110682270000,782623728.1,435427280.7,6.8,19856.1,3255.3,14.4,115400,107400,2354905000,21950,"2023-02-16T13:26:00.000Z",1676553960000,21950,21850,21850,93.5,6.5,0,3.2,0.4,,0.1,8000,123400,5055800,,2704505000,2529705000,174800000,
35729.8,1451900,31689030000,71099280000,39410250000,111560270000,782623728.1,435427280.7,2.5,19856.1,3255.3,Infinity,40000,40000,878000000,21950,"2023-02-16T13:28:00.000Z",1676554080000,21950,21950,21950,100,0,0,1.1,,,0,,40000,5095800,,878000000,878000000,,
35729.8,1497700,32695090000,72171190000,39476100000,112698030000,782623728.1,435427280.7,2.9,19856.1,3255.3,16.3,48800,45800,1006060000,22000,"2023-02-16T13:30:00.000Z",1676554200000,22000,21950,21950,94.2,5.8,0,1.4,0.2,,0.1,3000,51800,5147600,,1137760000,1071910000,65850000,
35729.8,1466900,32019040000,72467525000,40448485000,113966750000,782623728.1,435427280.7,-1.9,19856.1,3255.3,0.3,13500,-30800,-676050000,21950,"2023-02-16T13:32:00.000Z",1676554320000,22000,21950,21950,23.4,76.6,0,0.4,2.2,,3.3,44300,57800,5205400,,1268720000,296335000,972385000,
35729.8,1453600,31727720000,72823115000,41095395000,114969250000,782623728.1,435427280.7,-0.8,19856.1,3255.3,0.5,16200,-13300,-291320000,21950,"2023-02-16T13:34:00.000Z",1676554440000,21950,21900,21950,35.4,64.6,0,0.5,1.5,,1.8,29500,45700,5251100,,1002500000,355590000,646910000,
35729.8,1465500,31988925000,73145780000,41156855000,115353375000,782623728.1,435427280.7,0.8,19856.1,3255.3,5.3,14700,11900,261205000,21950,"2023-02-16T13:36:00.000Z",1676554560000,21950,21950,21950,84,16,0,0.4,0.1,,0.2,2800,17500,5268600,,384125000,322665000,61460000,
35729.8,1450700,31664315000,73277730000,41613415000,115941885000,782623728.1,435427280.7,-0.9,19856.1,3255.3,0.3,6000,-14800,-324610000,21950,"2023-02-16T13:38:00.000Z",1676554680000,22000,21950,22000,22.4,77.6,0,0.2,1,,3.5,20800,26800,5295400,,588510000,131950000,456560000,
35729.8,1444700,31532640000,73288730000,41756090000,116095560000,782623728.1,435427280.7,-0.4,19856.1,3255.3,0.1,500,-6000,-131675000,21950,"2023-02-16T13:40:00.000Z",1676554800000,22000,21950,21950,7.1,92.9,0,0,0.3,,13,6500,7000,5302400,,153675000,11000000,142675000,
35729.8,1437400,31372405000,73288730000,41916325000,116255795000,782623728.1,435427280.7,-0.5,19856.1,3255.3,0,,-7300,-160235000,21950,"2023-02-16T13:42:00.000Z",1676554920000,21950,21950,21950,0,100,0,,0.4,,Infinity,7300,7300,5309700,,160235000,,160235000,
35729.8,1400000,30551480000,73341410000,42789930000,117182080000,782623728.1,435427280.7,-2.4,19856.1,3255.3,0.1,2400,-37400,-820925000,21950,"2023-02-16T13:44:00.000Z",1676555040000,21950,21900,21950,5.7,94.3,0,0.1,2,,16.6,39800,42200,5351900,,926285000,52680000,873605000,
35729.8,1413900,30856615000,73734345000,42877730000,117662815000,782623728.1,435427280.7,0.9,19856.1,3255.3,4.5,17900,13900,305135000,22000,"2023-02-16T13:46:00.000Z",1676555160000,22000,21950,21950,81.7,18.3,0,0.5,0.2,,0.2,4000,21900,5373800,,480735000,392935000,87800000,
35729.8,1415700,30896295000,73809145000,42912850000,117772735000,782623728.1,435427280.7,0.1,19856.1,3255.3,2.1,3400,1800,39680000,22000,"2023-02-16T13:48:00.000Z",1676555280000,22000,21950,22000,68,32,0,0.1,0.1,,0.5,1600,5000,5378800,,109920000,74800000,35120000,
35729.8,1409100,30751465000,73826745000,43075280000,117952765000,782623728.1,435427280.7,-0.4,19856.1,3255.3,0.1,800,-6600,-144830000,21950,"2023-02-16T13:50:00.000Z",1676555400000,22000,21950,22000,9.8,90.2,0,0,0.4,,9.3,7400,8200,5387000,,180030000,17600000,162430000,
35729.8,1409800,30766940000,73875145000,43108205000,118034090000,782623728.1,435427280.7,0,19856.1,3255.3,1.5,2200,700,15475000,22000,"2023-02-16T13:52:00.000Z",1676555520000,22000,21950,22000,59.5,40.5,0,0.1,0.1,,0.7,1500,3700,5390700,,81325000,48400000,32925000,
35729.8,1409800,30766975000,73890545000,43123570000,118064855000,782623728.1,435427280.7,0,19856.1,3255.3,1,700,0,35000,22000,"2023-02-16T13:54:00.000Z",1676555640000,22000,21950,21950,50,50,0,0,0,,1,700,1400,5392100,,30765000,15400000,15365000,
35729.8,1394200,30424610000,73914745000,43490135000,118455620000,782623728.1,435427280.7,-1,19856.1,3255.3,0.1,1100,-15600,-342365000,21950,"2023-02-16T13:56:00.000Z",1676555760000,22000,21950,21950,6.2,93.8,0,0,0.8,,15.2,16700,17800,5409900,,390765000,24200000,366565000,
35729.8,1354100,29544415000,73914745000,44370330000,119335815000,782623728.1,435427280.7,-2.5,19856.1,3255.3,0,,-40100,-880195000,21950,"2023-02-16T13:58:00.000Z",1676555880000,21950,21950,21950,0,100,0,,2,,Infinity,40100,40100,5450000,,880195000,,880195000,
35729.8,1279200,27904440000,74061815000,46157375000,121269930000,782623728.1,435427280.7,-4.7,19856.1,3255.3,0.1,6700,-74900,-1639975000,21950,"2023-02-16T14:00:00.000Z",1676556000000,22000,21900,21950,7.6,92.4,0,0.2,4.1,,12.2,81600,88300,5538300,,1934115000,147070000,1787045000,
35729.8,1240200,27048495000,74108015000,47059520000,122218275000,782623728.1,435427280.7,-2.5,19856.1,3255.3,0.1,2100,-39000,-855945000,21950,"2023-02-16T14:02:00.000Z",1676556120000,22000,21950,22000,4.9,95.1,0,0.1,2.1,,19.6,41100,43200,5581500,,948345000,46200000,902145000,
35729.8,1239400,27030990000,74200255000,47169265000,122420260000,782623728.1,435427280.7,-0.1,19856.1,3255.3,0.8,4200,-800,-17505000,22000,"2023-02-16T14:04:00.000Z",1676556240000,22000,21900,21950,45.7,54.3,0,0.1,0.3,,1.2,5000,9200,5590700,,201985000,92240000,109745000,
35729.8,1239900,27042355000,74371855000,47329500000,122752095000,782623728.1,435427280.7,0,19856.1,3255.3,1.1,7800,500,11365000,21950,"2023-02-16T14:06:00.000Z",1676556360000,22000,21950,22000,51.7,48.3,0,0.2,0.4,,0.9,7300,15100,5605800,,331835000,171600000,160235000,
35729.8,1221300,26634275000,74455455000,47821180000,123327375000,782623728.1,435427280.7,-1.2,19856.1,3255.3,0.2,3800,-18600,-408080000,22000,"2023-02-16T14:08:00.000Z",1676556480000,22000,21950,22000,14.5,85.5,0,0.1,1.1,,5.9,22400,26200,5632000,,575280000,83600000,491680000,
35729.8,1193400,26021875000,74457655000,48435780000,123944175000,782623728.1,435427280.7,-1.8,19856.1,3255.3,0,100,-27900,-612400000,21950,"2023-02-16T14:10:00.000Z",1676556600000,22000,21950,21950,0.4,99.6,0,0,1.4,,280,28000,28100,5660100,,616800000,2200000,614600000,
35729.8,1194900,26054830000,74503750000,48448920000,124003410000,782623728.1,435427280.7,0.1,19856.1,3255.3,3.5,2100,1500,32955000,21900,"2023-02-16T14:12:00.000Z",1676556720000,21950,21900,21950,77.8,22.2,0,0.1,0,,0.3,600,2700,5662800,,59235000,46095000,13140000,
35729.8,1194100,26037435000,74558625000,48521190000,124130555000,782623728.1,435427280.7,-0.1,19856.1,3255.3,0.8,2500,-800,-17395000,21950,"2023-02-16T14:14:00.000Z",1676556840000,21950,21900,21900,43.1,56.9,0,0.1,0.2,,1.3,3300,5800,5668600,,127145000,54875000,72270000,
35729.8,1208000,26342550000,74868120000,48525570000,124444430000,782623728.1,435427280.7,0.9,19856.1,3255.3,70.5,14100,13900,305115000,21950,"2023-02-16T14:16:00.000Z",1676556960000,21950,21900,21950,98.6,1.4,0,0.4,0,,0,200,14300,5682900,,313875000,309495000,4380000,
35729.8,1266500,27626785000,76303810000,48677025000,126031575000,782623728.1,435427280.7,3.7,19856.1,3255.3,9.5,65400,58500,1284235000,21950,"2023-02-16T14:18:00.000Z",1676557080000,22000,21950,21950,90.5,9.5,0,1.8,0.3,,0.1,6900,72300,5755200,,1587145000,1435690000,151455000,
35729.8,1255900,27394305000,76387410000,48993105000,126431255000,782623728.1,435427280.7,-0.7,19856.1,3255.3,0.3,3800,-10600,-232480000,22000,"2023-02-16T14:20:00.000Z",1676557200000,22000,21950,22000,20.9,79.1,0,0.1,0.7,,3.8,14400,18200,5773400,,399680000,83600000,316080000,
35729.8,1269800,27700355000,76803210000,49102855000,126956805000,782623728.1,435427280.7,0.9,19856.1,3255.3,3.8,18900,13900,306050000,21950,"2023-02-16T14:22:00.000Z",1676557320000,22000,21950,22000,79.1,20.9,0,0.5,0.3,,0.3,5000,23900,5797300,,525550000,415800000,109750000,
35729.8,1472200,32154040000,81645410000,49491370000,132187520000,782623728.1,435427280.7,12.8,19856.1,3255.3,12.4,220100,202400,4453685000,21950,"2023-02-16T14:24:00.000Z",1676557440000,22000,21950,21950,92.6,7.4,0,6.2,0.9,,0.1,17700,237800,6035100,,5230715000,4842200000,388515000,
35729.8,1749600,38257195000,87812305000,49555110000,138418155000,782623728.1,435427280.7,17.6,19856.1,3255.3,96.7,280300,277400,6103155000,22050,"2023-02-16T14:26:00.000Z",1676557560000,22050,21950,22000,99,1,0,7.8,0.1,,0,2900,283200,6318300,,6230635000,6166895000,63740000,
35729.8,1809600,39580395000,89219105000,49638710000,139908555000,782623728.1,435427280.7,3.8,19856.1,3255.3,16.8,63800,60000,1323200000,22100,"2023-02-16T14:28:00.000Z",1676557680000,22100,22000,22000,94.4,5.6,0,1.8,0.2,,0.1,3800,67600,6385900,,1490400000,1406800000,83600000,
35729.8,1809600,39580395000,89219105000,49638710000,147024755000,782623728.1,435427280.7,0,19856.1,3255.3,NaN,,0,0,22100,"2023-02-16T14:44:00.000Z",1676558640000,22100,22100,22100,0,0,100,,,98.9,NaN,,322000,6707900,322000,7116200000,,,7116200000
